가나이트 : gahnite
가네팅 : garnetting
가넷 : garnett
가니메데 : ganymede
가니어라이트 : garnierite
가다 : gadda
가다메스 : gadames
가돌리나이트 : gadolinite
가드 : guard
가드너 : gardiner
가드너 : gardner
가딩 : guarding
가레트 : garrett
가르강튀아 : gargantua
가르보르그 : garborg
가르신 : garshin
가리 : gary
가리알 : garial
가마 : gama
가말리엘 : gamaliel
가뱅 : gabin
가보 : gabo
가보로네 : gaborone
가봉 : gabon
가브리엘 : gabriel
가브리엘리 : gabrieli
가비 : garvey
가비지 : garbage
가상디 : gassendi
가소올 : gasohol
가솔린 : gasoline
가스 : gas
가스테리아 : gasteria
가스트리노마 : gastrinoma
가스트린 : gastrin
가십 : gossip
가얄 : gayal
가우스 : gauss
가우타마 : gautama
가우하티 : gauhati
가워 : gower
가이거 : geiger
가이다르 : gaidar
가이드 : guide
가이드 : guides
가이벨 : geibel
가이슬러 : geissler
가이아 : gaea
가이아나 : guyana
가이저 : geyser
가자 : gaza
가자니아 : gazania
가제트 : gazette
가젤 : gazelle
가톨릭 : catholic
가폰 : gapon
가프 : garp
가피시 : garfish
간다라 : gandhara
간디 : gandhi
간디즘 : gandhiism
갈 : gal
갈 : gall
갈 : galle
갈라고 : galago
갈라세토페논 : gallacetophenone
갈라테이아 : galateia
갈락탄 : galactan
갈락토사민 : galactosamine
갈락토시드 : galactoside
갈란타민 : galanthamine
갈란투스 : galanthus
갈레 : galle
갈레노스 : galenos
갈루아 : galois
갈리마르 : gallimard
갈리아 : gallia
갈릭 : garlic
갈릴리 : galilee
갈바노미터 : galvanometer
갈바니 : galvani
감비아 : gambia
강가 : gang
강글리오시드 : ganglioside
강스 : gance
강토크 : gangtok
개그 : gag
개노필라이트 : ganophyllite
개더 : gather
개런티 : guarantee
개릭 : garrick
개버딘 : gaberdine
개서 : gasser
개스킷 : gasket
개짓 : gadget
갠트 : gantt
갤러리 : gallery
갤러핑 : galloping
갤런 : gallon
갤럽 : gallop
갤럽 : gallup
갤럽 : galop
갤리어드 : galliard
갭 : gap
갱 : gang
거버너 : governor
거베라 : gerbera
거슈윈 : gershwin
거터 : gutter
거트 : gut
거피 : guppy
건 : gunn
건서 : gunther
건터 : gunter
검 : gum
게 : ge
게겐바우어 : gegenbaur
게드 : guesde
게라 : gera
게라시모프 : gerasimov
게르니카 : guernica
게르마니아 : germania
게르마니쿠스 : germanicus
게르비누스 : gervinus
게르첸 : gertsen
게르하르트 : gerhardt
게리 : gary
게리맨더링 : gerrymandering
게리케 : guericke
게릴라 : guerrilla
게바라 : guevara
게브 : geb
게스너 : gesner
게스트 : guest
게오르게 : george
게이블 : gable
게이세리쿠스 : geisericus
게이지 : gauge
게이트 : gate
게이트웨이 : gateway
게인 : gain
게일 : gale
게임 : game
게임스 : games
게터 : getter
게토 : ghetto
겐타마이신 : gentamycin
겐트 : gent
겐티아나 : gentiana
겔리우스 : gellius
고 : go
고가르텐 : gogarten
고나도트로핀 : gonadotropin
고니오미터 : goniometer
고니오포토미터 : goniophotometer
고더드 : goddard
고도프스키 : godowsky
고두노프 : godunov
고든 : gordon
고딕 : gothic
고라크푸르 : gorakhpur
고르차코프 : gorchakov
고를로프카 : gorlovka
고릴라 : gorilla
고몽 : gaumont
고바 : gobat
고비노 : gobineau
고세크 : gossec
고센 : gossen
고셋 : gosset
고스트 : ghost
고시 : ghosh
고아 : goa
고어텍스 : goretex
고촐리 : gozzoli
고치 : gozzi
고키 : gorky
고타 : gotha
고트발도프 : gottwaldov
고트셰트 : gottsched
고트하르트 : gotthard
고트호프 : godthaab
고티에 : gautier
고프먼 : goffman
곡 : gog
곤다르 : gondar
곤차로프 : goncharov
골고다 : golgotha
골도니 : goldoni
골드 : gold
골드망 : goldman
골드스미스 : goldsmith
골드윈 : goldwyn
골딩 : golding
골리즘 : gaullism
골번 : goulburn
골즈워디 : galsworthy
골지 : golgi
골턴 : galton
골트슈타인 : goldstein
골포스트 : goalpost
골프 : golf
곰퍼스 : gompers
공 : gong
공쿠르 : goncourt
과라나 : guarana
과르니에리 : guarnieri
과르디 : guardi
과리니 : guarini
과야킬 : guayaquil
과율 : guayule
과테말라 : guatemala
괄리오르 : gwalior
괴벨 : goebel
괼링크스 : geulincx
구나르손 : gunnarson
구라미 : gourami
구르디예프 : gurdiiev
구르몽 : gourmont
구스 : goes
구스베리 : gooseberry
구스타브 : guatav
구아네티딘 : guanethidine
구아노 : guano
구아노신 : guanosine
구아닌 : guanine
구아버 : guava
구종 : goujon
구치 : gooch
구타 : gutta
구텐베르크 : gutenberg
군둘리치 : gunduli
군투르 : guntur
굴드베르그 : guldberg
굼플로비치 : gumplowicz
굽타 : gupta
굿맨 : goodman
귀르비치 : gurvitch
귀엔 : guyenne
귀요 : guyau
그나이스트 : gneist
그나이제나우 : gneisenau
그네툼 : gnetum
그라나 : grana
그라나다 : granada
그라나도스 : granados
그라미시딘 : gramicidin
그라베 : grabbe
그라비어 : gravure
그라스 : grass
그라스만 : grassmann
그라우트 : grout
그라운드 : ground
그라운딩 : grounding
그라이프스발트 : greifswald
그라인더 : grinder
그라인딩 : grinding
그라츠 : graz
그라티아이 : gratiae
그라프 : graaf
그라프만 : grabmann
그람 : gramme
그람마티쿠스 : grammaticus
그람시 : gramsci
그래놀리식 : granolithic
그래머 : grammer
그래스텍스 : grasstex
그래프 : graph
그래픽 : graphic
그래픽스 : graphics
그랜드스탠드 : grandstand
그랜트 : grant
그램 : gram
그레고리 : gregory
그레고리우스 : gregorius
그레나다 : grenada
그레셤 : gresham
그레이 : gray
그레이 : grey
그레이드 : grade
그레이딩 : grading
그레이버 : graver
그레이엄 : graham
그레이엄 : grahame
그레이트 : great
그레이하운드 : greyhound
그레인 : grain
그레코 : greco
그렌펠 : grenfell
그로 : gros
그로닝겐 : groningen
그로메르 : gromaire
그로미코 : gromyko
그로세 : grosse
그로셴 : groschen
그로스 : gross
그로스테스트 : grossetest
그로즈니 : groznyi
그로테볼 : grotewohl
그로테펜트 : grotefend
그로트 : grote
그로티우스 : grotius
그로피우스 : gropius
그뢰즈 : greuze
그루 : grew
그루지야 : gruziya
그루피 : groopie
그룬트비 : grundtvig
그룹 : group
그룹웨어 : groupware
그뤼미오 : grumiaux
그리그 : grieg
그리냐르 : grignard
그리녹 : greenock
그리드 : greed
그리드 : grid
그리멜스하우젠 : grimmelshausen
그리세오풀빈 : griseofulvin
그리스 : grease
그리스 : greece
그리즐리 : grizzly
그리지 : grisi
그리피사이트 : griffithite
그리피스 : griffith
그리핀 : griffin
그린 : greene
그린 : grin
그린란드 : greenland
그린빌 : greenville
그린즈버러 : greensboro
그릴 : grill
그릴파르처 : grillparzer
그림 : grimm
그립 : grip
글라디올러스 : gladiolus
글라스 : glass
글라신 : glassine
글라이더 : glider
글라이드 : glide
글라이딩 : gliding
글라주노프 : glazunov
글랏코프 : gladkov
글래드스턴 : gladstone
글래스펠 : glaspell
글러브 : glove
글레어 : glare
글레이즈 : gleizes
글레이징 : glazing
글로 : glow
글로리아 : gloria
글로리오사 : gloriosa
글로벌리즘 : globalism
글로브 : globe
글로비게리나 : globigerina
글로빈 : globin
글로시 : glossy
글록시니아 : gloxinia
글루 : glue
글루온 : gluon
글루카곤 : glucagon
글루코오스 : glucose
글루코제네시스 : glucogenesis
글루코코르티코이드 : glucocorticoid
글루크 : gluck
글루타민 : glutamine
글루타티온 : glutathione
글루테티미드 : glutethimide
글루텐 : gluten
글루텔린 : glutelin
글리벤클라마이드 : glibenclamide
글리비체 : gliwice
글리세롤 : glycerol
글리세리드 : glyceride
글리세린 : glycerin
글리시리진 : glycyrrhizin
글리오톡신 : gliotoxin
글리옥살 : glyoxal
글리옥살린 : glyoxaline
글리코겐 : glycogen
글리코시드 : glycoside
글리콜 : glycol
글린카 : glinka
기 : ghee
기가 : giga
기간토프테리스 : gigantopteris
기간토피테쿠스 : gigantopithecus
기그 : gig
기누라 : gynura
기니 : guinea
기드온 : gideon
기르케 : gierke
기를란다요 : ghirlandajo
기번 : gibbon
기벨린 : ghibelline
기브스 : gibbs
기센 : giessen
기싱 : gissing
기아나 : guiana
기어 : gear
기요맹 : guillaumin
기욤 : guillaume
기제브레히트 : giesebrecht
기조 : guizot
기타 : guitar
기타리스트 : guitarist
기트리 : guitry
기혼 : gihon
길 : gill
길갈 : gilgal
길구드 : gielgud
길더 : guilder
길딩 : gilding
길랴크 : gilyak
길리기아 : cilicia
길버트 : gilbert
길보아 : gilboa
길브레스 : gilbreth
나기브 : naguib
나나 : nana
나노미터 : nanometer
나노앰프 : nanoamp
나다나엘 : nathanael
나다르 : nadar
나레이터 : narrator
나르비크 : narvik
나르세스 : narses
나르시시스트 : narcissist
나르시시즘 : narcissism
나르코틴 : narcotine
나르키소스 : narcissos
나르텍스 : narthex
나망간 : namangan
나바라 : navarra
나바테아 : nabatea
나보코프 : nabokov
나사 : nasa
나사르 : nasarr
나세르 : nasser
나세리즘 : nasserism
나소 : nassau
나시크 : nasik
나우루 : nauru
나우만 : naumann
나이드라지드 : nydrazid
나이로비 : nairobi
나이만 : naiman
나이지리아 : nigeria
나이터 : nighter
나이트 : knight
나이트가운 : nightgown
나이트캡 : nightcap
나이트클럽 : nightclub
나이프 : knife
나인 : nine
나인 : nines
나인핀스 : ninepins
나일로틱 : nilotic
나일론 : nylon
나지 : nadge
나치즘 : nazism
나쿠루 : nakuru
나탈 : natal
나토 : nato
나토르프 : natorp
나티에 : nattier
나폴리 : napoli
나프록센 : naproxen
나프탈렌 : naphthalene
나프톨 : naphthol
나프틸아민 : naphthylamine
나홋카 : nakhodka
나흐티갈 : nachtigal
난센 : nansen
난센스 : nonsense
날로르핀 : nalorphine
날부핀 : nalbuphine
날트렉손 : naltrexone
남딘 : namdinh
낭시 : nancy
낭테르 : nanterre
낭트 : nantes
내레이터 : narrator
내로캐스팅 : narrowcasting
내비게이션 : navigation
내셔널리즘 : nationalism
내시 : nash
내추럴 : natural
낸드 : nand
냅색 : knapsack
냅킨 : napkin
너스 : nurse
너클 : knuckle
너트 : nut
널 : null
넘버 : number
넘버링 : numbering
네거티브 : negative
네게브 : negev
네덜란드 : netherlands
네레우스 : nereus
네로 : nero
네루 : nehru
네르갈 : nergal
네르바 : nerva
네르친스크 : nerchinsk
네르투스 : nerthus
네른스트 : nernst
네마토다 : nematoda
네메시스 : nemesis
네베로프 : neverov
네뷸러 : nebula
네소돈 : nesodon
네스메야노프 : nesmeyanov
네스토리우스 : nestorius
네스트로이 : nestroy
네안더 : neander
네오마이신 : neomycin
네오세라토더스 : neoceratodus
네오슈와게리나 : neoschwagerina
네오칼라미테스 : neocalamites
네오펜탄 : neopentane
네오프렌 : neoprene
네오필리나 : neopilina
네온 : neon
네이메겐 : nijmegen
네이샤부르 : neyshabur
네이선 : nathan
네이즈미스 : nasmyth
네임 : name
네즈발 : nezval
네차예프 : nechaev
네케르 : necker
네크라소프 : nekrasov
네크라인 : neckline
네트 : net
네트워크 : network
네팔 : nepal
네페르툼 : nefertum
네펜테스 : nepenthes
네포스 : nepos
네프 : nep
네프론 : nephron
네프스키 : nevskii
넥 : neck
넥쇠 : nex
넥타 : nectar
넥톤 : nekton
넨니 : nenni
넬레우스 : neleus
넵 : nep
넵투누스 : neptunus
넵투늄 : neptunium
노 : no
노난 : nonane
노넷 : nonet
노더 : norther
노듈 : nodule
노드 : node
노라 : nora
노라드 : norad
노라이즘 : noraism
노르넨 : nornen
노르디데 : nordide
노르망디 : normandie
노르아드레날린 : noradrenalin
노르에피네프린 : norepinephrine
노르웨이 : norway
노리시 : norrish
노리치 : norwich
노멀 : normal
노모그래프 : nomograph
노모그램 : nomogram
노모스 : nomos
노미널 : nominal
노미네이트 : nominate
노바 : nova
노베르 : noverre
노벨 : nobel
노벨륨 : nobelium
노벨티 : novelty
노벰비킨 : novembichin
노보비오신 : novobiocin
노보시비르스크 : novosibirsk
노보쿠즈네츠크 : novokuznetsk
노볼락 : novolak
노붐 : novum
노브 : knob
노비알 : novial
노비코프 : novikov
노빌레 : nobile
노사크 : nossack
노스럽 : northrop
노스카핀 : noscapine
노스클리프 : northcliffe
노스탈쟈 : nostalgia
노스탤지어 : nostalgia
노아 : noa
노어 : nor
노에제네시스 : noegenesis
노이만 : neumann
노이즈 : noise
노이트라 : neutra
노즐 : nozzle
노치 : notch
노커 : knocker
노킹 : knocking
노탐 : notam
노토르니스 : notornis
노트 : knot
노트 : note
노트북 : notebook
노플리우스 : nauplius
녹스 : knox
녹아웃 : knockout
녹턴 : nocturne
녹토비전 : noctovision
논스톱 : nonstop
논악틴 : nonactin
논임팩트 : nonimpact
논픽션 : nonfiction
놀데 : nolde
놀리나 : nolina
놉 : nob
뇌터 : noether
뇨르드 : njord
누나탁 : nunatak
누드 : nude
누들 : noodle
누르미 : nurmi
누르하치 : nurhachi
누메논 : noumenon
누비아 : nubia
누악쇼트 : nouakchott
누쿠스 : nukus
뉘앙스 : nuance
뉴 : new
뉴게이트 : newgate
뉴랜드 : nieuwland
뉴랜즈 : newlands
뉴런 : neuron
뉴먼 : newman
뉴볼트 : newbolt
뉴스 : news
뉴캐슬 : newcastle
뉴커먼 : newcomen
뉴컴 : newcomb
뉴클레오닉스 : nucleonics
뉴클레오시드 : nucleoside
뉴클레오히스톤 : nucleohistone
뉴클레인 : nuclein
뉴턴 : newton
뉴트론 : neutron
뉴트리노 : neutrino
뉴트리아 : nutria
뉴포트 : newport
늄 : neume
늄 : nium
니그로 : negro
니그로신 : nigrosine
니그로이드 : negroid
니네베 : nineveh
니니브 : ninib
니더 : kneader
니들 : needle
니라 : nira
니리다졸 : niridazole
니미츠 : nimitz
니벨슨 : nevelson
니부어 : niebuhr
니스 : nice
니스타틴 : nystatin
니아메 : niamey
니야 : niya
니어 : near
니에오 : nieo
니오베 : niobe
니장 : nizan
니제르 : niger
니진스키 : nizhinskii
니체 : nietzsche
니체이즘 : nietzscheism
니카라과 : nicaragua
니커보커스 : knickerbockers
니커스 : knickers
니컬슨 : nicolson
니케 : nice
니케서마이드 : nikethamide
니켈 : nickel
니코 : nicot
니코시아 : nicosia
니코틴아미드 : nicotinamide
니콘 : nikon
니콜 : nicol
니콜라에바 : nikolaeva
니콜라예프 : nikolaev
니콜라우스 : nicolaus
니콜라이트 : niccolite
니크롬 : nichrome
니클리슈 : nichlisch
니트 : knit
니트 : nit
니트라민 : nitramine
니트로겐 : nitrogen
니트로구아니딘 : nitroguanidine
니트로글리세린 : nitroglycerin
니트로나프탈렌 : nitronaphthalene
니트로메탄 : nitromethane
니트로민 : nitromine
니트로셀룰로오스 : nitrocellulose
니트로소 : nitroso
니트로소아민 : nitrosoamine
니트로톨루엔 : nitrotoluene
니트로파라핀 : nitroparaffin
니트로페놀 : nitrophenol
니트론 : nitron
니트릴 : nitrile
니티놀 : nitinol
니퍼 : nipper
니푸르 : nippur
니플헤임 : niflheim
닉네임 : nickname
닉스 : nics
닌히드린 : ninhydrin
닐 : neill
닐가이 : nilgai
닐소니아 : nilssonia
닐슨 : neilson
님루드 : nimrud
님포마니아 : nymphomania
님프 : nymph
닙코 : nipkow
다간 : dagan
다게르 : daguerre
다게스탄 : dagestan
다나오스 : danaos
다네만 : dannemann
다니엘 : daniel
다닐레프스키 : danilevskii
다다이스트 : dadaist
다다이즘 : dadaism
다르고미슈스키 : dargomyzhskii
다르마락사 : dharmaraksa
다르마키르티 : dharmakirti
다르질링 : darjeeling
다르한 : darchan
다름슈타트 : darmstadt
다마르 : dammar
다마스쿠스 : damascus
다마스크 : damask
다미아니 : damiani
다미에타 : damietta
다바오 : davao
다블뤼 : daveluy
다비 : dabit
다비 : darby
다스드 : dasd
다오넬라 : daonella
다우든 : dowden
다우슨 : dowson
다운 : down
다운사이징 : downsizing
다운타운 : downtown
다울런드 : dowland
다윈 : darwin
다이 : die
다이내믹 : dynamic
다이너마이트 : dynamite
다이너모 : dynamo
다이너모미터 : dynamometer
다이너트론 : dynatron
다이넬 : dynel
다이달로스 : daedalos
다이버터 : diverter
다이브 : dive
다이빙 : diving
다이스만 : deissmann
다이시 : dicey
다이아몬드 : diamond
다이아진 : diazine
다이알로그 : dialogue
다이알리시스 : dialysis
다이애미트럴 : diametral
다이어그램 : diagram
다이어리 : diary
다이어토닉 : diatonic
다이어트 : diet
다이어프램 : diaphragm
다이얼로그 : dialogue
다이오드 : diode
다이옥신 : dioxine
다인 : dyne
다인스 : dines
다임러 : daimler
다카르 : dakar
다큐드라마 : docudrama
다크 : dark
다키아 : dacia
다트 : dart
다프니스 : daphnis
다하나 : dahana
다호메이 : dahomey
단네브로 : dannebrog
단바드 : dhanbad
단치히 : danzig
달라디에 : daladier
달라이 : dalai
달라피콜라 : dallapiccola
달레 : dallet
달리 : dali
달리아 : dahlia
달링토니아 : darlingtonia
달마티아 : dalmatia
달마티안 : dalmatian
달크로즈 : dalcroze
담 : dam
담 : damn
대거 : dagger
대미지 : damage
대빗 : davit
댄디 : dandy
댄디즘 : dandyism
댄버라이트 : danburite
댄스 : dance
댄싱 : dancing
댈러스 : dallas
댐퍼 : damper
댐피어 : dampier
더 : the
더글러스 : douglas
더니든 : dunedin
더들리 : dudley
더미 : dummy
더반 : durban
더블 : double
더블릿 : doublet
더블헤더 : doubleheader
더비 : derby
더스트 : dust
더치 : dutch
더킹 : ducking
더프 : duff
더플 : duffle
덕 : duck
던 : donne
던디 : dundee
던롭 : dunlop
던스터블 : dunstable
덜레스 : dulles
덜루스 : duluth
덤웨이터 : dumbwaiter
덤퍼 : dumper
덤프 : dump
덤핑 : dumping
덩컨 : duncan
덩크 : dunk
데 : des
데네볼라 : denebola
데네브 : deneb
데니 : denny
데니어 : denier
데니킨 : denikin
데데킨트 : dedekind
데드 : dead
데드록 : deadlock
데리스 : derris
데릭 : derrick
데마고기 : demagogy
데마고기즘 : demagogism
데먼스트레이션 : demonstration
데멜 : dehmel
데모 : demo
데모스테네스 : demosthenes
데물랭 : desmoulins
데미안 : demian
데민포름 : deminform
데바닷타 : devadatta
데보린 : deborin
데뷔 : debut
데브스 : debs
데블 : devil
데비트로세라믹스 : devitroceramics
데스 : death
데스노스 : desnos
데스모솜 : desmosome
데스모케라스 : desmoceras
데스모프레신 : desmopressin
데스캔트 : descant
데스크톱 : desktop
데스피오 : despiau
데시 : dessye
데시리터 : deciliter
데시미터 : decimeter
데시벨 : decibel
데시케이터 : desiccator
데시프라민 : desipramine
데우칼리온 : deucalion
데이모스 : deimos
데이비 : davy
데이비드 : david
데이비슨 : davisson
데이케어 : daycare
데이터 : data
데이터베이스 : database
데이터폰 : dataphone
데이트 : date
데일 : dale
데자르그 : desargue
데카그램 : decagram
데카당스 : decadence
데카라켓 : decaracket
데카르트 : descartes
데카리터 : decaliter
데카메론 : decameron
데카트론 : decatron
데칸 : decane
데칼로그 : decalogue
데커레이션 : decoration
데클러메이션 : declamation
데탕트 : detente
데프콘 : defcon
덱 : deck
덱사메타손 : dexamethasone
덱스트린 : dextrin
덴드로븀 : dendrobium
덴마크 : denmark
덴시토미터 : densitometer
델 : dell
델라 : della
델레다 : deledda
델리 : delhi
델리커시 : delicacy
델릴라 : delilah
델카세 : delcass
델타 : delta
델피 : delphi
델피닌 : delphinine
도그마 : doga
도그마 : dogma
도그머티즘 : dogmatism
도나투스 : donatus
도너 : donor
도넛 : doughnut
도네츠크 : donetsk
도니체티 : donizetti
도데 : daudet
도도 : dodo
도레 : dor
도르니에 : dornier
도르트문트 : dortmund
도리 : dorie
도마크 : domagk
도메인 : domain
도미나투스 : dominatus
도미넌트 : dominant
도미니카 : dominica
도미니크 : dominic
도미에 : daumier
도버 : dover
도베르만 : dobermann
도부타민 : dobutamine
도브롤류보프 : dobrolyubov
도브잔스키 : dobzhansky
도비니 : daubigny
도스 : dos
도스킨 : doeskin
도스토예프스키 : dostoevskii
도시미터 : dosimeter
도어 : door
도이지 : doisy
도일 : doyle
도지 : dodge
도큐멘테이션 : documentation
도트 : dot
도파 : dopa
도파민 : dopamine
도프슈 : dopsch
도프젠코 : dovzhenko
도플러 : doppler
도하 : doha
독 : dock
독소루비신 : doxorubicin
독시사이클린 : doxycycline
독트린 : doctrine
돈 : don
돌 : dhole
돌로마이트 : dolomite
돌로스톤 : dolostone
돌멘 : dolmen
돌비 : dolby
돌턴 : dalton
돌핀 : dolphin
돔 : dome
돔페리돈 : domperidone
두라초 : durazzo
두랄루민 : duralumin
두랑고 : durango
두리안 : durian
두메르그 : doumergue
두바이 : dubai
두브로브니크 : dubrovnik
두샨베 : dushanbe
두알라 : douala
둠야트 : dumyat
둠즈데이 : domesday
뒤귀 : duguit
뒤르켕 : durkheim
뒤마 : dumas
뒤부아 : dubois
뒤스부르크 : duisburg
뒤아멜 : duhamel
뒤카 : dukas
뒤코묑 : ducommun
뒤클로 : duclos
뒤프레 : dupr
뒤플렉스 : dupleix
뒤피 : dufy
듀공 : dugong
듀랜트 : durant
듀베리 : dewberry
듀어 : dewar
듀얼 : dual
듀엣 : duet
듀이 : dewey
듀테론 : deuteron
듀테륨 : deuterium
드가 : degas
드네프로페트로프스크 : dnepropetrovsk
드니 : denis
드라마티스트 : dramatist
드라세나 : dracaena
드라이 : dry
드라이버 : driver
드라이브 : drive
드라이빙 : driving
드라이저 : dreiser
드라콘 : drakon
드라큘라 : dracula
드라크만 : drachmann
드람멘 : drammen
드래건 : dragon
드래그라인 : dragline
드래프트 : draft
드램 : dram
드러그 : drug
드럼 : drum
드레스 : dress
드레스덴 : dresden
드레싱 : dressing
드레이퍼 : draper
드레저 : dredger
드레퓌스 : dreyfus
드로어즈 : drawers
드로이젠 : droysen
드로잉 : drawing
드롭 : drop
드롭스 : drops
드롭아웃 : dropout
드롭킥 : dropkick
드롭트 : dropped
드리블 : dribble
드리오피테쿠스 : dryopithecus
드리프트 : drift
드리핑 : dripping
드릴링 : drilling
드립 : drip
드링크 : drink
드뷔시 : debussy
들라로슈 : delaroche
들라크루아 : delacroix
들리브 : delibes
디거 : digger
디거스 : diggers
디기탈리스 : digitalis
디기톡신 : digitoxin
디나르 : dinar
디노미네이션 : denomination
디노사우르 : dinosaur
디뉴클레오티드 : dinucleotide
디도 : dido
디드로 : diderot
디램 : dram
디레다와 : diredawa
디렉터리 : directory
디르함 : dirham
디리클레 : dirichlet
디맨드 : demand
디메르카프롤 : dimercaprol
디메트로돈 : dimetrodon
디메틸니트로사민 : dimethylnitrosamine
디메틸아민 : dimethylamine
디멘히드리네이트 : dimenhydrinate
디모르포테카 : dimorphotheca
디미트로프 : dimitrov
디바가시옹 : divagations
디바이 : debye
디바이스 : device
디버그 : debug
디버깅 : debugging
디벨리우스 : dibelius
디보란 : diborane
디부카인 : dibucaine
디센딩 : descending
디스인플레이션 : disinflation
디스카운트 : discount
디스커스 : discuss
디스켓 : diskette
디스코 : disco
디스코볼로스 : diskobolos
디스코키클리나 : discocyclina
디스코텍 : discotheque
디스클로저 : disclosure
디스턴스 : distance
디스템퍼 : distemper
디스토피아 : dystopia
디스트로이어 : destroyer
디스트로피 : dystrophy
디스패처 : dispatcher
디스포저 : disposer
디스프로슘 : dysprosium
디스플레폰 : displephone
디시램브 : dithyramb
디아 : dia
디아나 : diana
디아민 : diamine
디아밀아민 : diamylamine
디아세테이트 : diacetate
디아세틸모르핀 : diacetylmorphine
디아스 : dias
디아제팜 : diazepam
디아조메탄 : diazomethane
디아조타이프 : diazotype
디어본 : dearbon
디엘드린 : dieldrin
디오게네스 : diogenes
디오니시우스 : dionysius
디오라마 : diorama
디오르 : dior
디오클레티아누스 : diocletianus
디오판토스 : diophantos
디옥산 : dioxane
디옥시리보오스 : deoxyribose
디올레핀 : diolefin
디옵터 : diopter
디우레틱 : diuretic
디자이너 : designer
디자인 : design
디젤 : diesel
디졸브 : dissolve
디즈니 : disney
디즈레일리 : disraeli
디지타이저 : digitizer
디지털 : digital
디코더 : decoder
디코드 : decode
디키 : dickey
디킨스 : dickens
디킨슨 : dickinson
디터미니즘 : determinism
디터스도르프 : dittersdorf
디테일 : detail
디트로이트 : detroit
디티존 : dithizone
디퍼렌셜 : differential
디페닐히단토인 : diphenylhydantoin
디펜베이커 : diefenbaker
디펜스 : defence
디포스겐 : diphosgene
디프 : deep
디프레션 : depression
디프테리아 : diphtheria
디플레이션 : deflation
디플레이터 : deflator
디플렉터 : deflector
디플로도쿠스 : diplodocus
디플로디늄 : diplodinium
디필로스 : diphilos
딕 : dick
딕션 : diction
딕시 : dixie
딕시랜드 : dixieland
딕시크랫 : dixiecrat
딕티오네마 : dictyonema
딕티오필룸 : dictyophyllum
딘 : dean
딜러 : dealer
딜럭스 : deluxe
딜레마 : dilemma
딜레인 : delane
딜리 : dili
딜리셔스 : delicious
딜리어스 : delius
딜링 : dealing
딜타이 : dilthey
딜티아젬 : diltiazem
딤플 : dimple
딩기 : dinghy
라 : la
라 : ra
라가시 : lagash
라게르크비스트 : lagerkvist
라고스 : lagos
라그랑주 : lagrange
라놀린 : lanolin
라눙쿨루스 : ranunculus
라니티딘 : ranitidine
라다 : rada
라다만토스 : rhadamanthos
라돈 : radon
라돔 : radom
라듐 : radium
라드너 : lardner
라드브루흐 : radbruch
라들로프 : radlov
라디시체프 : radishchev
라디안 : radian
라디에이션 : radiation
라디오 : radio
라디오그래머폰 : radiogramophone
라디오그래프 : radiograph
라디오그램 : radiogram
라디오메탈 : radiometal
라디오미터 : radiometer
라디오악티늄 : radioactinium
라디오오토그래피 : radioautography
라디오토륨 : radiothorium
라디오폰 : radiophone
라디올라리아 : radiolaria
라디칼 : radical
라라 : lara
라레스 : lares
라르고 : largo
라르보 : larbaud
라르테 : lartet
라마 : lama
라마 : rama
라마르크 : lamarck
라마르틴 : lamartine
라마피테쿠스 : ramapithecus
라만 : rahman
라머 : larmer
라메 : lam
라멘트 : lament
라모 : rameau
라무스 : ramus
라뮈 : ramuz
라미 : ramie
라미나린 : laminarin
라바노테이션 : labanotation
라바터 : lavater
라바테라 : lavatera
라바트 : rabat
라발 : laval
라베 : lab
라베 : raabe
라벤나 : ravenna
라벤더 : lavender
라벨 : label
라부아지에 : lavoisier
라브랑 : laverant
라블레 : rabelais
라비 : rabi
라비린토스 : labyrinthos
라비린툴라 : labyrinthula
라사 : lhasa
라셸 : raschel
라소 : lasso
라슈누 : rashnu
라슈트 : rasht
라스 : lath
라스웰 : lasswell
라스크 : rask
라스타파리아니즘 : rastafarianism
라스파이레스 : laspeyres
라스푸틴 : rasputin
라시드 : rashid
라에 : lae
라에르티오스 : laertios
라에티 : raeti
라오스 : laos
라오카이 : laokay
라오콘 : laocoon
라왈핀디 : rawalpindi
라우라나 : laurana
라우렐 : laurel
라우스 : rous
라우에 : laue
라우월피아 : rauwolfia
라운드 : round
라운드헤즈 : roundheads
라운지 : lounge
라이 : lie
라이거 : liger
라이너 : liner
라이네케 : reinecke
라이노타이프 : linotype
라이니아 : rhynia
라이더 : rider
라이덴 : leiden
라이먼 : lyman
라이벌 : rival
라이베리아 : liberia
라이브러리 : library
라이블 : leibl
라이샤워 : reischauer
라이선스 : license
라이센스 : licence
라이소자임 : lysozyme
라이스 : rice
라이야트와리 : raiyatwari
라이어 : lyre
라이온스 : lions
라이터 : lighter
라이터 : writer
라이트 : right
라이트 : wright
라이프 : life
라이프치히 : leipzig
라이플 : rifle
라이헨바흐 : reichenbach
라인 : line
라인 : rhine
라인란트 : rheinland
라인피드 : linefeed
라인하르트 : reinhardt
라일 : ryle
라임 : lime
라임 : rhyme
라임라이트 : limelight
라제스 : rhazes
라줄리 : lazuli
라즈베리 : raspberry
라첸호퍼 : ratzenhofer
라카유 : lacaille
라케날리아 : lachenalia
라케다이몬 : lakedaimon
라켓 : racket
라코르데르 : lacordaire
라크 : lacq
라크로스 : lacrosse
라클로 : laclos
라킨 : larkin
라타키아 : latakia
라테라이트 : laterite
라텍스 : latex
라텔 : ratel
라트비아 : latvia
라티 : lahti
라티움 : latium
라파르그 : lafargue
라파엘 : raphael
라파엘로 : raffaello
라펠 : lapel
라포르그 : laforgue
라퐁텐 : lafontaine
라플란드 : lapland
라플레시아 : rafflesia
라피스 : lapis
라흐마니노프 : rakhmaninov
라흐만 : lachmann
락사토르 : laxator
락탄티우스 : lactantius
락탐 : lactam
락토글로불린 : lactoglobulin
락토플라빈 : laktoflavin
락톤 : lactone
락티드 : lactide
란다우 : landau
란도프스카 : landowska
란타나 : lantana
란타노이드 : lanthanoid
란타니드 : lanthanide
랄랑드 : lalande
랄로 : lalo
람다 : lambda
람베르트 : lambert
람부탄 : rambutan
람스테트 : ramstedt
람푸르 : rampur
람프레히트 : lamprecht
랍콘 : rapcon
랑 : laon
랑게 : lange
랑그도크 : languedoc
랑부예 : rambouillet
랑산 : langshan
랑송 : lanson
랑주뱅 : langevin
랑카과 : rancagua
랑케 : ranke
래그타임 : ragtime
래글런 : raglan
래더트론 : laddertron
래드클리프 : radcliffe
래디컬리즘 : radicalism
래미네이트 : laminate
래버러토리 : laboratory
래브라도 : labrador
래빗 : rabbit
래스키 : laski
래스터 : raster
래치 : latch
래커 : lacquer
래틀 : rattle
래티튜드 : latitude
래핑 : lapping
랙 : lac
랙 : rack
랜덤 : random
랜드 : land
랜드 : rand
랜딩 : landing
랜서스 : lancers
랜섬 : ransom
랜싱 : lansing
랜턴 : lantern
랠리 : rally
램 : ram
램버스 : lambeth
램버트 : rambert
램지 : ramsay
램프 : lamp
램프 : ramp
랩 : lap
랩 : rap
랩 : wrap
랩소디 : rhapsody
랩톱 : laptop
랭 : lang
랭글런드 : langland
랭글리 : langley
랭뮤어 : langmuir
랭스 : reims
랭커스터 : lancaster
랭킨 : rankine
랴잔 : ryazan
러거 : rugger
러그 : rug
러닝 : running
러더퍼드 : rutherford
러버 : rubber
러브 : love
러브버드 : lovebird
러셀 : russel
러스크 : rusk
러스킨 : ruskin
러시아 : russia
러커 : rucker
러크나우 : lucknow
러프 : rough
러프 : ruff
러플 : ruffle
럭 : ruck
럭비 : rugby
럭스 : lux
런던 : london
런던데리 : londonderry
런지 : lunge
럼 : rum
럼버 : lumber
럼지 : rumsey
레 : leh
레 : re
레가스피 : legaspi
레거 : reger
레게 : reggae
레겐스부르크 : regensburg
레굴루스 : regulus
레귤러 : regular
레귤레이션 : regulation
레그혼 : leghorn
레기오몬타누스 : regiomontanus
레기온 : legion
레나르트 : lenard
레나우 : lenau
레너 : renner
레노그램 : renogram
레니 : reni
레니나칸 : leninakan
레닌 : lenin
레닌 : renin
레닌그라드 : leningrad
레닛 : rennet
레다 : leda
레드톱 : redtop
레들리키아 : redlichia
레디 : redi
레딩 : reading
레르몬토프 : lermontov
레리 : leiris
레만 : lehmann
레모네이드 : lemonade
레몬 : lemon
레미니슨스 : reminiscence
레미콘 : remicon
레밍 : lemming
레반트 : levant
레버 : lever
레베데프 : lebedev
레벨 : level
레비레이트 : levirate
레빈 : lewin
레셉스 : lesseps
레소토 : lesotho
레스코 : lescaut
레스터 : leicester
레스피기 : respighi
레슨 : lesson
레시린 : lecirin
레시터티브 : recitative
레시틴 : lecithin
레싱 : lessing
레아 : rhea
레오타드 : leotard
레오파르디 : leopardi
레오펙시 : rheopexy
레온카발로 : leoncavallo
레우키포스 : leucippos
레이 : lei
레이거노믹스 : reaganomics
레이놀즈 : reynolds
레이니 : raney
레이더존데 : radarsonde
레이돔 : radome
레이디얼 : radial
레이먼드 : raymond
레이몬트 : reymont
레이블 : label
레이쇼 : ratio
레이스 : lace
레이스 : race
레이안드로스 : leiandros
레이어드 : layered
레이업 : layup
레이윈 : rawin
레이윈존데 : rawinsonde
레이저 : laser
레이콘 : racon
레이크 : lake
레이크 : rake
레이트레이싱 : raytracing
레이팅 : rating
레인 : lane
레인워터 : rainwater
레인저 : ranger
레인지 : range
레일 : rail
레일리 : rayleigh
레저 : ledger
레조르신 : resorcin
레졸 : resol
레즈비언 : lesbian
레지스탕스 : registance
레지스터 : register
레지스테이트 : resistate
레지오넬라 : legionella
레진 : resin
레치워스 : letchworth
레코드 : record
레코드 : recorde
레퀴엠 : requiem
레터링 : lettering
레테 : lethe
레토 : leto
레트 : let
레트로바이러스 : retrovirus
레트리버 : retriever
레티쿨린 : reticulin
레퍼리 : referee
레퍼터리 : repertory
레페 : reppe
레프트 : left
레플리카 : replica
레피도사이렌 : lepidosiren
레피도시클리나 : lepidocyclina
레피두스 : lepidus
렉싱턴 : lexington
렉틴 : lectin
렌 : renn
렌 : wren
렌더링 : rendering
렌즈 : lens
렌츠 : lenz
렌치 : wrench
렌트 : rent
렘니스케이트 : lemniscate
렘브란트 : rembrandt
렘샤이트 : remscheid
렙 : rep
렙시우스 : lepsius
렙토스피라 : leptospira
렙토시폰 : leptosiphon
렙톤 : lepton
로 : low
로 : roe
로 : row
로건베리 : loganberry
로고 : logo
로고스 : logos
로그 : log
로그우드 : logwood
로그인 : login
로댕 : rodin
로더 : loader
로데오 : rodeo
로도히폭시스 : rhodohypoxis
로돕신 : rhodopsin
로드 : laud
로드 : road
로드 : rod
로드스터 : roadster
로디지아 : rhodesia
로딩 : loading
로라시아 : laurasia
로랑 : laurent
로랑생 : laurencin
로랑스 : laurens
로렌 : lorraine
로렌슘 : lawrencium
로렌스 : lawrence
로렌초 : lorenzo
로렐라이 : lorelei
로르카 : lorca
로리스 : loris
로마 : roma
로마노프 : romanov
로마니스트 : romanist
로맨스 : romance
로맨티시즘 : romanticism
로맹 : romain
로맹 : romains
로메오 : romeo
로멜 : rommel
로모노소프 : lomonosov
로물루스 : romulus
로미오 : romeo
로바스타틴 : lovastatin
로버 : rover
로버트슨 : robertson
로베스피에르 : robespierre
로벨린 : lobeline
로보톨로지 : robotology
로볼루션 : robolution
로브 : lob
로브스터 : lobster
로비 : lobby
로비아 : robbia
로빈 : robin
로빈슨 : robinson
로사 : rosa
로사리오 : rosario
로세티 : rossetti
로셀리니 : rossellini
로션 : lotion
로소 : rosso
로슈포르 : rochefort
로스 : loss
로스뷔 : rossby
로스차일드 : rothschild
로스켈리누스 : roscellinus
로스탕 : rostand
로스터 : roaster
로스토크 : rostock
로스트 : lost
로시니 : rossini
로엔그린 : lohengrin
로열티 : royalty
로욜라 : loyola
로우이사에 : louisae
로위 : loewy
로위 : lowie
로이드 : lloyd
로이스달 : ruysdael
로이카르트 : leuckart
로이터 : reuter
로자닐린 : rosaniline
로잔 : lausanne
로저스 : rodgers
로제타 : rosetta
로제트 : rosette
로젠베르크 : rosenberg
로젤 : roselle
로조 : roseau
로즈 : rhodes
로즈 : roze
로즈메리 : rosemary
로즈버리 : rosebery
로직 : logic
로진 : rosin
로진스키 : rodzinskii
로카 : roka
로카르노 : locarno
로커 : locker
로컬 : local
로케이션 : location
로켓 : locket
로쿤 : rockoon
로크 : lock
로크 : locke
로크아웃 : lockout
로키 : loki
로키탄스키 : rokitansky
로터 : rotor
로터리 : rotary
로터미터 : rotameter
로테르담 : rotterdam
로테이션 : rotation
로토 : lotto
로트 : lot
로트 : roth
로트레크 : lautrec
로트베르투스 : rodbertus
로티 : loti
로페 : lope
로프 : rope
로프웨이 : ropeway
로프트 : loft
로하스 : roxas
록 : rock
록아웃 : lockout
록펠러 : rockefeller
록펠러 : rockefellor
론 : lawn
론갈리트 : rongalite
론서스턴 : launceston
롤 : role
롤랑 : rolland
롤러 : roller
롤러폴로 : rollerpolo
롤리 : raleigh
롤리타 : lolita
롤링 : rolling
롤링스 : rawlings
롤스 : rolls
롬 : rom
롬니 : romney
롬바드 : lombard
롬버그 : romberg
롬베르크 : romberg
롬브로소 : lombroso
롱 : long
롱기 : longhi
롱기누스 : longinus
롱샹 : longchamp
롱클로스 : longcloth
롱펠로 : longfellow
뢰비 : loewi
루 : roux
루가노 : lugano
루나 : luna
루나차르스키 : lunacharskii
루네베리 : runeberg
루니크 : lunik
루덴도르프 : ludendorff
루덴스 : rudens
루디아나 : ludhiana
루딘 : rudin
루르 : ruhr
루리스탄 : luristan
루리아 : luria
루리야 : luriya
루멘 : lumen
루멜리아 : rumelia
루뭄바 : lumumba
루미솜 : lumisome
루뱅 : louvain
루베 : rouvaix
루벤스 : rubens
루붐바시 : lubumbashi
루블린 : lublin
루비 : ruby
루비듐 : rubidium
루사카 : lusaka
루세 : ruse
루셀 : roussel
루스 : loose
루스 : luce
루스 : ruth
루스티카나 : rusticana
루시타니아 : lusitania
루시퍼 : lucifer
루안다 : luanda
루앙 : rouen
루오 : rouault
루이빌 : louisville
루이사이트 : lewisite
루이스 : lewis
루이즈 : louise
루지 : luge
루체른 : luzern
루카 : lucca
루카누스 : lucanus
루카스 : lucas
루키아노스 : lucianos
루타 : ruta
루타바가 : rutabaga
루테늄 : ruthenium
루테인 : lutein
루테튬 : lutetium
루트 : root
루트 : route
루틴 : routine
루틴 : rutin
루틸 : rutile
루피 : rupee
루피아 : rupiah
루핀 : lupine
룩 : look
룩셈부르크 : luxemburg
룩소르 : luxor
룰 : rule
룰렛 : roulette
룸 : room
룸비니 : lumbin
룽게 : rounge
룽게 : runge
뤼드 : rude
뤼드베리 : rydberg
뤼트뵈프 : rutbeuf
류리크 : ryurik
류머티즘 : rheumatism
류블랴나 : ljubljana
류트 : lute
르 : le
르나르 : renard
르네 : ren
르노 : renault
르노르망 : lenormand
르누아르 : lenoir
르누아르 : renoir
르동 : redon
르베리에 : leverrier
르블랑 : leblanc
르사주 : lesage
르장드르 : legendre
르클뤼 : reclus
르페브르 : lefebvre
리 : lee
리 : leigh
리 : lie
리가아제 : ligase
리간드 : ligand
리겔 : rigel
리그 : rig
리그노카인 : lignocaine
리그니츠 : liegnitz
리그로인 : ligroin
리기노덴드론 : lyginodendron
리기놉테리스 : lyginopteris
리날로올 : linalool
리넨 : linen
리넨 : lynen
리노바이러스 : rhinovirus
리녹신 : linoxyn
리놀륨 : linoleum
리니어 : linear
리니어먼트 : lineament
리더 : leader
리더쉽 : leadership
리더십 : leadership
리덕션 : reduction
리도카인 : lidocaine
리드 : lead
리드 : read
리드 : reed
리드 : reid
리드맨 : leadman
리듬 : rhythm
리디아 : lydia
리딩 : leading
리릭 : lyric
리마 : lima
리마솔 : limassol
리머릭 : limerick
리메 : rimet
리메인 : remain
리멘슈나이더 : riemenschneider
리모나이트 : limonite
리모주 : limoges
리모트 : remote
리무쟁 : limousin
리밋 : limit
리바운드 : rebound
리바이벌 : revival
리버설 : reversal
리버스 : reverse
리버티 : liberty
리베라 : ribera
리베라 : rivera
리베로 : libero
리베르만 : liebermann
리베이루 : ribeiro
리베이트 : rebate
리베팅 : riveting
리벤트로프 : ribbentrop
리벳 : rivet
리보뉴클레아제 : ribonuclease
리보니아 : livonia
리보르노 : livorno
리보오스 : ribose
리보플래빈 : riboflavin
리본 : ribbon
리봅 : rebop
리부팅 : rebooting
리브 : rib
리비 : libby
리비도 : libido
리비스 : leavis
리비에라 : riviera
리비히 : liebig
리빙 : living
리빙스턴 : livingstone
리사이클링 : recycling
리사주 : lissajous
리살 : rizal
리서치 : research
리센코 : lysenko
리셉션 : reception
리셋 : reset
리소그래프 : lithograph
리소그래피 : lithography
리소스타핀 : lysostaphin
리소토 : risotto
리슐리외 : richelieu
리스 : lease
리스케줄링 : rescheduling
리스크 : risk
리스크스 : risks
리스트 : list
리스트 : liszt
리스트릭티드 : restricted
리스프 : lisp
리시닌 : ricinine
리시버 : receiver
리시아스 : lysias
리시포스 : lysippos
리신 : lysine
리아드 : riad
리아제 : lyase
리알 : rial
리액터그레이드 : reactorgrade
리액턴스 : reactance
리야드 : riyadh
리언 : lien
리얼리스트 : realist
리엔지니어링 : reengineering
리엘 : riel
리예카 : rijeka
리오네 : lyonnet
리올로지 : rheology
리옹 : lyon
리우빌 : liouville
리자이나 : regina
리저널리즘 : regionalism
리조푸스 : rhizopus
리즈 : leeds
리처드슨 : richardson
리츨 : ritschl
리치 : leach
리치 : reach
리치먼드 : richmond
리칭 : leaching
리카도 : ricardo
리커버리 : recovery
리케르트 : rickert
리케차 : rickettsia
리코더 : recorder
리코딩 : recording
리코프 : rykov
리쿠르고스 : lycourgos
리퀘스트 : request
리큐어 : liqueur
리크 : leek
리크리에이션 : recreation
리키 : leakey
리터 : liter
리터 : ritter
리터구트 : rittergut
리턴 : lytton
리턴 : return
리토폰 : lithopone
리튬 : lithium
리트레 : littr
리트머스 : litmus
리틀 : little
리틀턴 : littleton
리티곤 : litigon
리파이너리 : refinery
리파티 : lipatti
리팜피신 : rifampicin
리퍼 : reaper
리페츠크 : lipetsk
리포메이션 : reformation
리포솜 : liposome
리포스트 : riposte
리포이드 : lipoid
리포트 : report
리포트로핀 : lipotropin
리프 : leaf
리프레서 : repressor
리프레션 : repression
리프레인 : refrain
리프만 : lippmann
리프먼 : lipmann
리프먼 : lippmann
리프트 : lift
리프팅 : lifting
리플 : ripple
리플렉스 : reflex
리플릿 : leaflet
리피 : lippi
리피트 : repeat
리필 : refill
리허빌리테이션 : rehabilitation
리후에 : lihue
리히터 : richter
리히텐베르크 : lichtenberg
릭 : lick
린 : lean
린네 : linn
린데 : linde
린덴 : lindane
린드그렌 : lindgren
린드버그 : lindbergh
린드블라드 : lindblad
린스호텐 : linschoten
린지 : lindsey
린츠 : linz
린코마이신 : lincomycin
린터 : linter
린턴 : linton
릴 : lille
릴 : reel
릴 : riehl
릴레이 : relay
릴레이션스 : relations
릴롱궤 : lilongwe
릴리 : lyly
릴리서 : releaser
릴리스 : release
릴리엔크론 : liliencron
릴리엔탈 : lilienthal
릴리우오칼라니 : liliuokalani
릴리퍼 : reliefer
릴리프 : relief
릴케 : rilke
림 : rim
림랜드 : rimland
림보 : limbo
림포카인 : lymphokine
림프 : lymph
립 : rip
립스틱 : lipstick
립턴 : lipton
링 : ring
링가옌 : lingayen
링거 : ringer
링단 : lingdan
링커 : linker
링컨 : lincoln
링크 : rink
링키지 : linkage
마가다 : magadha
마거리 : margary
마거리트 : marguerite
마곡 : magog
마그날륨 : magnalium
마그네사이트 : magnesite
마그네슘 : magnesium
마그네타이트 : magnetite
마그네토 : magneto
마그네토그래프 : magnetograph
마그네트론 : magnetron
마그넷 : magnet
마그넷 : margnet
마그누스 : magnus
마그니스터 : magnister
마그데부르크 : magdeburg
마그리트 : magritte
마그마 : magma
마기 : magi
마나과 : managua
마나마 : manama
마나우스 : manaos
마냐니 : magnani
마네 : manet
마네킨 : mannequin
마노미터 : manometer
마농 : manon
마니아 : mania
마닐라 : manila
마다가스카르 : madagascar
마데로 : madero
마데르노 : maderno
마두라 : madura
마드라스 : madras
마드론 : madrone
마드리드 : madrid
마드바 : madhva
마라 : mara
마라 : marat
마라카이 : maracay
마라카이보 : maracaibo
마라케시 : marrakech
마란타 : maranta
마람바 : maramba
마레 : marey
마루트 : marut
마르 : marr
마르그라프 : marggraf
마르두크 : marduk
마르멜로 : marmelo
마르세예즈 : marseillaise
마르셀 : marcel
마르슈너 : marschner
마르스 : mars
마르카브 : markab
마르케 : marquet
마르코 : marco
마르코스 : marcos
마르코프 : markov
마르쿠제 : marcuse
마르크스 : marx
마르크시스트 : marxist
마르크시즘 : marxism
마르탱 : martin
마르트노 : martenot
마르티 : mart
마르티농 : martinon
마르티누스 : martinus
마르티니 : martini
마르티알리스 : martialis
마르틴 : martin
마르틴손 : martinson
마리 : marie
마리골드 : marigold
마리네티 : marinetti
마리니 : marini
마리보 : marivaux
마리보르 : maribor
마리아나오 : marianao
마리오트 : mariotte
마리우스 : marius
마리탱 : maritain
마리화나 : marihuana
마리화나 : marijuana
마림바 : marimba
마멀레이드 : marmalade
마멋 : marmot
마블 : marble
마블링 : marbling
마블스 : marbles
마사와 : massawa
마사지 : massage
마사초 : masaccio
마세이오 : maceio
마셜 : marshall
마솔리노 : masolino
마쇼 : machaut
마수륨 : masurium
마슈하드 : mashhad
마스카니 : mascagni
마스카라 : mascara
마스코트 : mascotte
마스크 : mask
마스킹 : masking
마스터 : master
마스터베이션 : masturbation
마스터스 : masters
마스토돈 : mastodon
마스토돈사우루스 : mastodonsaurus
마스트 : mast
마스티프 : mastiff
마스페로 : maspero
마시 : marsh
마시멜로 : marshmallow
마신 : massine
마야코프스키 : mayakovskii
마욜 : maillol
마우드갈리아야나 : maudgalyayana
마우러 : maurer
마우스 : mouse
마우스피스 : mouthpiece
마운드 : mound
마운트배튼 : mountbatten
마운틴 : mountain
마이나데스 : maenades
마이너리티 : minority
마이너스 : minus
마이넛 : minot
마이농 : meinong
마이모니데스 : maimonides
마이몬 : maimon
마이스터 : meister
마이스터징거 : meistersinger
마이신 : mycin
마이애미 : miami
마이어 : meyer
마이어호프 : meyerhof
마이카 : mica
마이카나이트 : micanite
마이컬슨 : michelson
마이컴 : micom
마이코라이자 : mycorrhiza
마이크 : mike
마이크러지 : micrurgy
마이크로그램 : microgram
마이크로마이크로패럿 : micromicrofarad
마이크로모듈 : micromodule
마이크로미크론 : micromicron
마이크로밸런스 : microbalance
마이크로버스 : microbus
마이크로서저리 : microsurgery
마이크로솜 : microsome
마이크로옴 : microhm
마이크로웨이브 : microwave
마이크로일렉트로닉스 : microelectronics
마이크로카드 : microcard
마이크로캡슐 : microcapsule
마이크로코즘 : microcosm
마이크로퀴리 : microcurie
마이크로톰 : microtome
마이크로패럿 : microfarad
마이크로포토미터 : microphotometer
마이크로폰 : microphone
마이크로피시 : microfiche
마이크로필름 : microfilm
마이트너 : meitner
마인츠 : mainz
마일 : mile
마일러 : miler
마일스톤 : milestone
마일포스트 : milepost
마장디 : magendie
마저럼 : marjoram
마젤란 : magellan
마졸리카 : majolica
마주로 : majuro
마주르카 : mazurka
마진 : margin
마차도 : machado
마치 : march
마카렌코 : makarenko
마카로프 : makarov
마카리오스 : makarios
마커 : marker
마케도니아 : macedonia
마케예프카 : makeevka
마켓 : market
마코르 : markhor
마퀀드 : marquand
마크닌 : macnin
마크로키스티스 : macrocystis
마크맨 : markman
마키아벨리즘 : machiavellism
마타 : mata
마탄사스 : matanzas
마테를링크 : maeterlinck
마테오 : matteo
마테존 : matheson
마트 : maat
마티니 : martini
마티스 : matisse
마푸토 : maputo
마필린도 : maphilindo
마하 : mach
마호가니 : mahogany
마호메트 : mahomet
마흐 : mach
막달레나 : magdalena
막사이사이 : magsaysay
막시미아누스 : maximianus
만 : man
만 : mann
만나 : manna
만다린 : mandarin
만달레이 : mandalay
만데르 : mander
만딩고 : mandingo
만리케 : manrique
만사니요 : manzanillo
만테냐 : mantegna
만토바니 : mantovani
만틸라 : mantilla
말라가시 : malagasy
말라르메 : mallarm
말라리아 : malaria
말라야 : malaya
말라위 : malawi
말라카 : malacca
말러 : mahler
말레 : mal
말레르브 : malherbe
말레이 : malay
말레이시아 : malaysia
말레인 : mallein
말로 : malot
말로 : malraux
말로 : marlowe
말리 : mali
말리노프스키 : malinowski
말리크 : malik
말뫼 : malm
말브랑슈 : malebranche
말토오스 : maltose
맘바 : mamba
망가나이트 : mangnite
망고스틴 : mangosteen
망사르 : mansart
매거진 : magazine
매그니튜드 : magnitude
매너 : manner
매너리즘 : mannerism
매뉴얼 : manual
매뉴팩처 : manufacture
매니저 : manager
매니큐어 : manicure
매니토 : manito
매니토이즘 : manitoism
매디슨 : madison
매러케인 : marocain
매럿 : marett
매스 : mass
매스콘 : mascon
매스터스 : masters
매시매틱스 : mathematics
매신저 : massinger
매직 : magic
매카시 : mccarthy
매카시즘 : mccarthyism
매컬러스 : mccullers
매코믹 : mccormick
매콜리 : macaulay
매크로 : macro
매크로엔지니어링 : macroengineering
매크로파지 : macrophage
매클라우드 : macleod
매클리시 : macleish
매킨더 : mackinder
매킨리 : mckinley
매트 : mat
매트리스 : mattress
맥니스 : macneice
맥도널드 : macdonald
맥도월 : macdowell
맥루언 : mcluhan
맥마흔 : mcmahon
맥밀런 : macmillan
맥베스 : macbeth
맥브라이드 : macbride
맥스웰 : maxwell
맥시멈 : maximum
맥심 : maxim
맥아더 : macarthur
맨더빌 : mandeville
맨데이머스 : mandamus
맨드릴 : mandrel
맨션 : mansion
맨스필드 : mansfield
맨시니 : mancini
맨틀 : mantel
맨틀 : mantle
맨틀피스 : mantelpiece
맨홀 : manhole
맬러리 : malory
맬러머드 : malamud
맵 : map
맹그로브 : mangrove
머건탈러 : mergenthaler
머니터리 : monetary
머니터리즘 : monetarism
머니퓰레이터 : manipulator
머더보드 : motherboard
머드 : mud
머리 : murray
머스캣 : muscat
머스크 : musk
머스터드 : mustard
머시닝 : machining
머시룸 : mushroom
머천다이징 : merchandising
머천트 : merchant
머캐덤 : macadam
머큐로크롬 : mercurochrome
머큐리 : mercury
머프 : muff
머피 : murphy
머핀 : muffin
머핸 : mahan
먼 : mun
먼로 : monroe
먼셀 : munsell
멀러 : muller
멀리컨 : mulliken
멀칭 : mulching
멀티미디어 : multimedia
멀티비전 : multivision
멀티숍 : multishop
멀티웨이 : multiway
멀티채널 : multichannel
멀티큐브 : multicube
멀티프로그래밍 : multiprogramming
멀티플 : multiple
멀티플렉서 : multiplexer
멈퍼드 : mumford
멍크 : monk
멍키 : monkey
메가데스 : megadeath
메가론 : megaron
메가바 : megabar
메가비트 : megabit
메가사이클 : megacycle
메가스테네스 : megasthenes
메가테리움 : megatherium
메가톤 : megaton
메가폰 : megaphone
메간트로푸스 : meganthropus
메갈로파 : megalopa
메갈로폴리스 : megalopolis
메그옴 : megohm
메기도 : megiddo
메난드로스 : menandros
메넬라오스 : menelaos
메논 : menon
메뉴 : menu
메달 : medal
메달리스트 : medalist
메더워 : medawar
메두사 : medusa
메들리 : medley
메디나 : medina
메디아 : media
메디안 : median
메디오스 : medios
메디컬 : medical
메러디스 : meredith
메레주코프스키 : merezhkovskii
메로에 : mero
메루트 : meerut
메르센 : mersenne
메르쿠리 : mercouri
메르쿠리우스 : mercurius
메리 : mary
메리노 : merino
메리엄 : merriam
메리테리움 : moeritherium
메링 : mehring
메모리 : memory
메바스타틴 : mevastatin
메세 : messe
메셰드 : meshed
메소머리즘 : mesomerism
메소사우루스 : mesosaurus
메소솜 : mesosome
메소토미 : mesotomy
메소트론 : mesotron
메소포타미아 : mesopotamia
메손 : meson
메스 : mes
메스 : metz
메스암페타민 : methamphetamine
메스칼린 : mescaline
메스트르 : maistre
메시아 : messiah
메시아니즘 : messianism
메시앙 : messiaen
메시지 : message
메시틸렌 : mesitylene
메신저 : messenger
메이스 : mace
메이스필드 : masefield
메이예 : meillet
메이저 : major
메이저 : maser
메이커 : maker
메이폴 : maypole
메인 : main
메인 : maine
메인슬 : mainsail
메일 : mail
메저 : measure
메추 : metsu
메치니코프 : metchnikoff
메카 : mecca
메커 : meker
메커니컬 : mechanical
메타 : meta
메타니제이션 : methanization
메타돈 : methadone
메타세쿼이아 : metasequoia
메타센터 : metacenter
메타스타시오 : metastasio
메타콸론 : methaqualone
메타크로머시 : metachromasy
메타크세니아 : metaxenia
메타프로테인 : metaprotein
메탄 : methane
메탄올 : methanol
메탈로이드 : metalloid
메탈리카 : metallica
메탈리콘 : metallicon
메토 : meto
메토트렉사트 : methotrexate
메톤 : meton
메트로놈 : metronome
메트로니다졸 : metronidazole
메트로폴리스 : metropolis
메티오닌 : methionine
메틸 : methyl
메틸글리옥살 : methylglyoxal
메틸도파 : methyldopa
메틸렌 : methylene
메틸벤젠 : metylbenzene
메프로바메이트 : meprobamate
메피스토 : mephisto
메피스토펠레스 : mephistopheles
멕시칼리 : mexicali
멕시코 : mexico
멘데레스 : menderes
멘델레븀 : mendelevium
멘델레예프 : mendeleev
멘델존 : mendelsohn
멘셰비즘 : menshevism
멘스트루에이션 : menstruation
멘첼 : menzel
멘탄 : menthane
멘톤 : menthone
멜라닌 : melanin
멜라민 : melamine
멜라카 : melaka
멜란히톤 : melanchton
멜람푸스 : melampus
멜랑콜리 : melancholy
멜레나 : melena
멜레아그로스 : meleagros
멜로드라마 : melodrama
멜로디언 : melodion
멜론 : melon
멜루 : melo
멜리사 : melissa
멜리야 : melilla
멜바 : melba
멜빌 : melville
멜턴 : melton
멤논 : memnon
멤버 : member
멤버십 : membership
멤피스 : memphis
멩겔베르크 : mengelberg
멩스 : mengs
멩켄 : mencken
모가디슈 : mogadishu
모건 : morgan
모굴 : mogul
모나드 : monad
모나르키아니즘 : monarchianism
모나미 : monami
모나코 : monaco
모내드녹 : monadnock
모네 : monet
모네라 : monera
모네타 : moneta
모넬 : monel
모노그램 : monogram
모노드라마 : monodrama
모노디 : monody
모노레일 : monorail
모노마니아 : monomania
모노머 : monomer
모노스키 : monoski
모노시이즘 : monotheism
모노아민 : monoamine
모노코드 : monochord
모노크로메이터 : monochromator
모노크롬 : monochrome
모노타이프 : monotype
모노톤 : monotone
모노포니 : monophony
모니즈 : moniz
모니즘 : monism
모니카 : monica
모니터 : monitor
모니터링 : monitering
모더니스트 : modernist
모던 : modern
모델 : model
모델링 : modelling
모듈 : module
모듈러 : modular
모듈레이션 : modulation
모딜리아니 : modigliani
모라 : mora
모라다바드 : moradabad
모라토리엄 : moratorium
모랄리티 : morality
모럴 : moral
모럴리스트 : moralist
모레노 : moreno
모레인 : moraine
모렐리 : morelli
모렐리아 : morelia
모로 : moro
모로니 : moroni
모로코 : morocco
모르가니 : morgagni
모르겐슈테른 : morgenstern
모르타르 : mortar
모르핀 : morphine
모리 : moury
모리셔스 : mauritius
모리슨 : morrison
모리아크 : mauriac
모리조 : morisot
모린 : morin
모멘탈리즘 : momentalism
모멘트 : moment
모방 : maubant
모베리 : moberg
모브스 : mobs
모사데크 : mosaddeq
모사사우루스 : mossasaurus
모샤브 : moshav
모술 : mosul
모스 : morse
모스 : mos
모스카 : mosca
모스크 : mosque
모스크바 : moskva
모아 : moa
모에라이 : moerai
모이만 : meuman
모이즈 : moyse
모자이크 : mosaic
모즐리 : moseley
모차르트 : mozart
모카신 : moccasin
모크업 : mockup
모터 : motor
모터사이클 : motorcycle
모턴 : morton
모텔 : motel
모토 : motto
모티베이션 : motivation
모티브 : motive
모티비즘 : motivism
모페드 : moped
모페르튀이 : maupertuis
모펫 : moffet
몬나 : monna
몬드 : mond
몬드리안 : mondriaan
몬모릴로나이트 : montmorillonite
몬순 : monsoon
몬스테라 : monstera
몬테네그로 : montenegro
몬테레이 : monterrey
몬테마요르 : montemayor
몬테비데오 : montevideo
몬테소리 : montessori
몬텔리우스 : montelius
몬트필리어 : montpelier
몬티 : monti
몰 : maul
몰다비아 : moldavia
몰도바 : moldova
몰딩 : molding
몰딩 : moulding
몰레큘러 : molecular
몰렉트로닉스 : molectronics
몰로토프 : molotov
몰록 : moloch
몰리나 : molina
몰리니즘 : molinism
몰타 : malta
몰티즈 : maltese
몸 : maugham
몸바사 : mombasa
몽고메리 : montgomery
몽골 : mongol
몽골로이드 : mongoloid
몽구스 : mongoose
몽마르트르 : montmartre
몽주 : monge
몽테를랑 : montherlant
몽테스키외 : montesquieu
몽퇴 : monteux
몽파르나스 : montparnasse
몽펠리에 : montpellier
몽포르 : montfort
무니에 : mounier
무드 : mood
무렉시드 : murexide
무르만스크 : murmansk
무르시아 : murcia
무리요 : murillo
무비 : movie
무비올라 : moviola
무사 : mousa
무소르크스키 : musorgskii
무솔리니 : mussolini
무스카루핀 : muscarufin
무스카린 : muskarin
무스카트 : muscat
무스콘 : muscone
무스펠헤임 : muspelheim
무아상 : moissan
무어 : moore
무타나비 : mutanabbi
무타레 : mutare
무트 : mut
무함마드 : muhammad
물탄 : multan
뭄바이 : mumbai
뭉크 : munk
뮈르달 : myrdal
뮈세 : musset
뮤신 : mucin
뮤어 : muir
뮤온 : muon
뮤지컬 : musical
뮤직 : music
뮤코이드 : mucoid
미 : me
미그레닌 : migraenin
미그마타이트 : migmatite
미너렛 : minaret
미네랄 : mineral
미네랄로지 : mineralogy
미노 : minaux
미노스 : minos
미노타우로스 : minotauros
미뇽 : mignon
미뉴에트 : minuet
미니 : meany
미니디스크 : minidisk
미니멀리즘 : minimalism
미니멈 : minimum
미니버스 : minibus
미니애폴리스 : minneapolis
미니카 : minicar
미니컴퓨터 : minicomputer
미다스 : midas
미드십 : midship
미들 : middle
미들랜드 : midlands
미들즈브러 : middlesbrough
미들턴 : middleton
미디 : middy
미디안 : midian
미디어 : media
미디엄 : medium
미라보 : mirabeau
미라시듐 : miracidium
미란 : miran
미러 : mirror
미러클 : miracle
미로 : mir
미르보 : mirbeau
미마스 : mimas
미모사 : mimosa
미사일 : missile
미셀 : micelle
미셀러니 : miscellany
미셰르 : miescher
미쇼 : michaux
미슈콜츠 : miskolc
미스 : mis
미스 : miss
미스캐스트 : miscast
미스터리 : mystery
미스트라 : mistra
미스트랄 : mistral
미시스 : mysis
미야스코프스키 : myaskovskii
미오 : mio
미오그래프 : myograph
미오글로빈 : myoglobin
미요 : milhaud
미이라 : mirra
미자르 : mizar
미처리히 : mitscherlich
미첼 : mitchell
미추린 : michurin
미치나 : myitkyina
미카엘 : michael
미케네 : mycenae
미코얀 : mikoyan
미코톡신 : mycotoxin
미코플라스마 : mycoplasma
미크론 : mircon
미키 : mickey
미터 : meter
미토콘드리아 : mitochondria
미트 : meet
미트 : mitt
미트로폴로스 : mitropoulos
미팅 : meeting
미하일 : mikhail
미하일로프스키 : mikhailovskii
미헬스 : michels
믹서 : mixer
민스 : mince
민스크 : minsk
민스트럴 : minstrel
민코프스키 : minkowskii
민트 : mint
밀 : mil
밀라노 : milano
밀라니즈 : milanese
밀레 : millet
밀레이 : millais
밀레이 : millay
밀로 : milo
밀로나이트 : mylonite
밀로돈 : mylodon
밀류코프 : milyukov
밀른 : milne
밀리갈 : milligal
밀리리터 : milliliter
밀리몰 : millimole
밀리미크론 : millimicron
밀리볼트 : millivolt
밀리암미터 : milliammeter
밀리암페어 : milliampere
밀리컨 : millikan
밀리퀴리 : millicurie
밀링 : milling
밀워키 : milwaukee
밀턴 : milton
밀티아데스 : miltiades
밍거스 : mingus
밍크 : mink
바 : bar
바게트 : baguette
바그너 : wagner
바그다드 : baghdad
바기오 : baguio
바나나 : banana
바나듐 : vanadium
바나흐 : banach
바너드 : barnard
바누아투 : vanuatu
바닐라 : vanilla
바닐린 : vanillin
바다호스 : badajoz
바데 : baade
바덴 : baden
바돌리오 : badoglio
바라나시 : varanasi
바라이트 : barite
바라크 : barrack
바라틴스키 : baratynski
바랄 : bharal
바랑키야 : barranquilla
바레인 : bahrain
바레일리 : bareilly
바로 : varro
바로다 : baroda
바로미터 : barometer
바로스위치 : baroswitch
바륨 : barium
바르 : bahr
바르가 : varga
바르나 : varna
바르나울 : barnaul
바르부르크 : warburg
바르비탈 : barbital
바르샤바 : warszawa
바르셀로나 : barcelona
바르톨롬메오 : bartolommeo
바르트 : barth
바르트 : barthes
바를라흐 : barlach
바리 : bari
바리 : barye
바리온 : baryon
바리케이드 : barricade
바리콘 : varicon
바리톤 : baritone
바마코 : bamako
바모 : bhamo
바버리 : barbary
바버리즘 : barbarism
바베이도스 : barbados
바벨 : babel
바벨 : barbell
바비롤리 : barbirolli
바비루사 : babirusa
바비아나 : babiana
바비츠 : babits
바비큐 : barbecue
바빌로니아 : babylonia
바빌론 : babylon
바사 : vaasa
바사 : vasa
바서만 : wassermann
바셀린 : vaseline
바소프레신 : vasopressin
바수톨란드 : basutoland
바순 : bassoon
바슈키르 : bashkir
바스라 : basra
바스켓 : basket
바스크 : basque
바스트 : bast
바스트 : bust
바스티아 : bastia
바스티유 : bastille
바시트라신 : bacitracin
바실레프스카야 : vasilevskaya
바실리스크 : basilisk
바실리우스 : basilius
바실리카 : basilica
바아 : bar
바야돌리드 : valladolid
바얀 : bayan
바예호 : vallejo
바우마이스터 : baumeister
바우처 : voucher
바우히니아 : bauhinia
바운더리 : boundary
바운스 : bounce
바운즈 : bounds
바움가르텐 : baumgarten
바이 : bye
바이더벡 : beiderbecke
바이덴 : weyden
바이람 : bairam
바이러스 : virus
바이런 : byron
바이로이트 : bayreuth
바이마르 : weimar
바이브레이션 : vibration
바이블 : bible
바이센부르크 : weissenburg
바이스 : vice
바이스 : weiss
바이스마니즘 : weismannism
바이스만 : weismann
바이애슬론 : biathlon
바이어 : baeyer
바이어 : bayer
바이어 : buyer
바이어슈트라스 : weierstrass
바이어스 : bias
바이얼레이션 : violation
바이에라 : baiera
바이오닉스 : bionics
바이오리액터 : bioreactor
바이오마이신 : viomycin
바이오매스 : biomass
바이오메트리 : biometry
바이오새털라이트 : biosatellite
바이오소나 : biosonar
바이오칩 : biochip
바이오컴퓨터 : biocomputer
바이오트론 : biotron
바이오팜 : biofarm
바이오팩 : biopak
바이오해저드 : biohazard
바이온트 : vaiont
바이올렛 : violet
바이올리니스트 : violinist
바이올린 : violin
바이옴 : biome
바이츠만 : weizmann
바이코누르 : baikonur
바이콜로지 : bicology
바이타글라스 : vitaglass
바이타램프 : vitalamp
바이터스코프 : vitascope
바이털리즘 : vitalism
바이트 : bite
바이트 : byte
바인가르트너 : weingartner
바인더 : binder
바인딩 : binding
바일 : weil
바일 : weyl
바자 : bazzar
바제도 : basedow
바젤 : basel
바조프 : vazov
바지 : barge
바질 : basil
바캉스 : vacance
바켄로더 : wackenroder
바켈리 : bacchelli
바콜로드 : bacolod
바쿠닌 : bakunin
바쿠스 : bacchus
바크 : bark
바크하우스 : backhaus
바클라 : barkla
바클로펜 : baclofen
바타니 : battani
바타비아 : batavia
바타유 : bataille
바터 : barter
바텐더 : bartender
바토 : watteau
바투 : batu
바투미 : batumi
바튜슈코프 : batyushkov
바트가온 : bhatgaon
바트파라 : bhatpara
바틀릿 : bartlett
바티칸 : vatican
바하마 : bahamas
바하이즘 : bahaism
바흐오펜 : bachofen
바흐친 : bakhtin
바흐타란 : bakhtaran
바히아그라스 : bahiagrass
박스 : box
박스트 : bakst
박테리아 : bacteria
박테리오로돕신 : bacteriorhodopsin
박테리오신 : bacteriocin
박트리아 : bactria
반 : barn
반 : van
반다 : vanda
반달리즘 : vandalism
반데이라 : bandeira
반둥 : bandoeng
반자르마신 : bandjarmasin
반키바 : bankyba
반탐 : bantam
반텐 : banten
반투 : bantu
반투스탄 : bantustan
발 : bal
발도비네티 : baldovinetti
발둥 : baldung
발드르 : baldr
발라 : walras
발라동 : valadon
발라드 : ballad
발라키레프 : balakirev
발라흐 : wallach
발란친 : balanchin
발레 : ballet
발레타 : valleta
발렌슈타인 : wallenstein
발렌시아가 : balenciaga
발렌티노 : vallentino
발루키테리움 : baluchitherium
발리 : volley
발릭파판 : balikpapan
발린 : valine
발보아 : balboa
발사 : balsa
발삼 : balsam
발자크 : balzac
발장 : valjean
발코니 : balcony
발타리 : waltari
발터 : walter
발터 : walther
발파라이소 : valparaiso
밥 : bop
방갈로 : bungalow
방갈로르 : bangalore
방글라데시 : bangladesh
방다 : benda
방빌 : banville
방콕 : bangkok
배드 : bad
배드랜드 : badlands
배드민턴 : badminton
배리 : barrie
배리 : barry
배리스터 : varistor
배리캡 : varicap
배브콕 : babcock
배비지 : babbage
배서스트 : bathurst
배스 : bath
배젓 : bagehot
배처 : batcher
배치 : batch
배큐엄 : vacuum
배턴 : baton
배트 : bat
배트 : vat
배틀 : battle
배틱 : battik
배팅 : batting
백 : back
백 : bag
백개먼 : backgammon
백스 : backs
백스윙 : backswing
백스터 : baxter
백파이어 : backfire
백핸드 : backhand
밴드위스 : bandwidth
밴디지 : bandage
밴조 : banjo
밴티지 : vantage
밴팅 : banting
밸러스트 : ballast
밸류 : value
밸리 : valley
밸브 : valve
뱅커 : banker
뱅크 : bank
뱅킹 : banking
버그 : bug
버그먼 : bergman
버나드 : bernard
버널 : bernal
버넷 : burnett
버니 : burney
버니언 : bunyan
버드 : bird
버드 : byrd
버랙터 : varactor
버로스 : burroughs
버마 : burma
버밀리언 : vermilion
버밀리온 : vermilion
버밍엄 : birmingham
버배스컴 : verbascum
버뱅크 : burbank
버번 : bourbon
버블 : bubble
버스 : berth
버스 : bus
버스트 : bust
버슬 : bustle
버저 : buzzer
버지널 : virginal
버지니아 : virginia
버질 : virgil
버코프 : birkhoff
버크 : burke
버크럼 : buckram
버클륨 : berkelium
버클리 : berkeley
버클링 : buckling
버터 : butter
버터링 : buttering
버터밀크 : buttermilk
버턴 : burton
버트레스 : buttress
버튼 : button
버틀러 : butler
버티컬 : vertical
버팅 : butting
버펄로 : buffalo
버피팅 : buffeting
벅 : buck
번들 : bundle
번스 : burns
번스 : byrnes
번지 : bungee
번치 : bunche
번트 : bunt
벌류트 : volute
벌브 : bulb
벌커나이즈드 : vulcanized
벌크 : bulk
벌키 : bulky
범퍼 : bumper
베가 : vega
베가톤 : begaton
베강 : weygand
베고니아 : bogonia
베긴 : begin
베냐민 : benjamin
베네딕트 : bendict
베네딕틴 : benedictine
베네수엘라 : venezuela
베네시 : bene
베네치아 : venezia
베네티테스 : bennettites
베넷 : bennett
베노밀 : benomyl
베니딕트 : benedict
베니션 : venetian
베니스 : venice
베데스다 : bethesda
베데커 : baedeker
베데킨트 : wedekind
베도스 : beddoes
베드 : bed
베드니 : bedny
베라크루스 : veracruz
베라파밀 : verapamil
베란다 : veranda
베레사예프 : veresaev
베렌스 : behrens
베로나 : verona
베로니카 : veronica
베로키오 : verrocchio
베르가 : verga
베르거 : berger
베르겐 : bergen
베르겐그륀 : bergengruen
베르그송 : bergson
베르기우스 : bergius
베르길리우스 : vergilius
베르나드스키 : vernadskii
베르나르트 : beernaert
베르너 : werner
베르네 : vernet
베르노니아 : vernonia
베르누이 : bernoulli
베르니니 : bernini
베르니케 : wernicke
베르디 : verdi
베르메르 : vermeer
베르베린 : berberine
베르셀리우스 : berzelius
베르셰바 : beersheba
베르예론 : bergeron
베르크 : berg
베르테르 : werther
베르토 : berto
베르톨레 : berthollet
베르트람 : bertram
베르트랑 : bertrand
베르틀로 : berthelot
베르펠 : werfel
베르하렌 : verhaeren
베른 : bern
베른 : verne
베른슈타인 : bernstein
베를라헤 : berlage
베를렌 : verlaine
베를리너 : berliner
베를린 : berlin
베를링구에르 : berlinguer
베리만 : bergman
베리야 : beriya
베리에이션 : variation
베릴륨 : beryllium
베링 : bering
베바트론 : bevatron
베베르 : veber
베베른 : webern
베벨 : bebel
베브 : bev
베블런 : veblen
베빈 : bevin
베살리우스 : vesalius
베서머 : bessemer
베셀 : bessel
베스 : bes
베스타 : vesta
베스트 : best
베스트팔렌 : westfalen
베스파시아누스 : vespasianus
베스푸치 : vespucci
베어 : baer
베어 : bear
베어드 : baird
베어먼 : behrman
베어울프 : beowulf
베오그라드 : beograd
베이루트 : beirut
베이브 : babe
베이비 : baby
베이스 : bass
베이스맨 : baseman
베이스볼 : baseball
베이식 : basic
베이어 : baeyer
베이어 : conveyor
베이츠 : bates
베이커 : baker
베이컨 : bacon
베이클랜드 : baekeland
베이트슨 : bateson
베이퍼 : vapor
베자 : beza
베처먼 : betjeman
베츠 : beets
베케트 : beckett
베켓 : becket
베크 : becque
베크만 : beckmann
베클로메타손 : beclomethasone
베키오 : vecchio
베타 : betta
베타메타손 : betamethasone
베타카로틴 : betacarotin
베테랑 : veteran
베텔게우스 : betelgeuse
베토벤 : beethoven
베트민 : vietminh
베트콩 : vietcong
베티 : betti
베하임 : behaim
베허 : becher
베히스툰 : behistun
벡터스코프 : vectorscope
벤 : behn
벤 : ben
벤 : venn
벤담 : bentham
벤드 : bend
벤제드린 : benzedrine
벤젠 : benzene
벤조나테이트 : benzonatate
벤조알데히드 : benzoaldehyde
벤조퀴논 : benzoquinone
벤조페논 : benzophenone
벤졸 : benzol
벤지딘 : benzidine
벤진 : benzine
벤츠 : benz
벤츠 : vents
벤토나이트 : bentonite
벤토스 : benthos
벤투리 : venturi
벤트리스 : ventris
벨 : bayle
벨 : bell
벨데 : velde
벨라도나 : belladonna
벨라미 : belleami
벨라트릭스 : bellatrix
벨러미 : bellamy
벨러폰 : bellerphon
벨렘나이트 : belemnite
벨로나 : bellona
벨로시티 : velocity
벨록 : belloc
벨루어 : velour
벨리 : belly
벨리니 : bellini
벨리사리우스 : belisarius
벨리스 : bellis
벨리즈 : belize
벨린스키 : belinskii
벨링스하우젠 : bellingshausen
벨모판 : belmopan
벨벳 : velvet
벨테브레 : weltevree
벨파스트 : belfast
벨하벤 : welhaven
벰보 : bembo
보가드 : vogad
보고르 : bogor
보고타 : bogot
보나르 : bonnard
보나파르트 : bonaparte
보낭 : bonang
보너빌 : bonneville
보너스 : bonus
보넬리아 : bonellia
보노미 : bonomi
보닛 : bonnet
보댕 : bodin
보더 : border
보데 : bode
보들레르 : baudelaire
보디 : body
보디스 : bodice
보라 : bora
보라존 : borazon
보라졸 : borazol
보레아스 : boreas
보렐 : borel
보로 : borrow
보로디노 : borodino
보로딘 : borodin
보로미니 : borromini
보로실로브그라드 : voroshilovgrad
보로실로프 : voroshilov
보르데 : bordet
보르자 : borgia
보르조이 : borzoi
보르탁 : vortac
보르하르트 : borchardt
보르헤르트 : borchert
보르헤스 : borges
보름스 : worms
보리스 : boris
보링 : boring
보마르셰 : beaumarchais
보먼 : bowman
보방 : vauban
보베리 : boveri
보부아르 : beauvoir
보브캣 : bobcat
보빈 : bobbin
보샹 : beauchamp
보쉬에 : bossuet
보슈 : bosch
보스 : bose
보스니아 : bosnia
보스코 : bosco
보스턴 : boston
보아 : boa
보애스 : boas
보어 : boer
보어홀 : borehole
보엔 : bowen
보예르 : bojer
보이스 : boys
보이스 : voice
보이스트 : beust
보이아르도 : boiardo
보이오티아 : boiotia
보이코트 : boycott
보이콰이어 : boychoir
보이텐조르히 : buitenzorg
보이티우스 : boethius
보일 : voile
보일러 : boiler
보잉 : bowing
보즈웰 : boswell
보즌켓 : bosanquet
보초니 : boccioni
보츠와나 : botswana
보카제 : bocage
보카치오 : boccaccio
보컬 : vocal
보컬리스트 : vocalist
보케리니 : boccherini
보크 : balk
보크라인 : balkline
보크사이트 : bauxite
보탈로 : botallo
보터 : boater
보텀 : bottom
보테프 : botev
보토쿠도 : botocudo
보툴리누스 : botulinus
보틀넥 : bottleneck
보티시즘 : vorticism
보티첼리 : botticelli
보퍼트 : beaufort
보프 : bopp
보헤미아 : bohemia
보훔 : bochum
복서 : boxer
복스 : box
본 : bonn
본 : vaughan
본드 : bond
본테복 : bontebok
본템펠리 : bontempelli
본회퍼 : bonhoeffer
볼 : bowl
볼고그라드 : volgograd
볼드 : bold
볼런터리 : voluntary
볼로그다 : vologda
볼로냐 : bologna
볼륨 : volume
볼리비아 : bolivia
볼링 : bowling
볼슨 : bolson
볼차노 : bolzano
볼치 : balch
볼타 : volta
볼타미터 : voltameter
볼테르 : voltaire
볼토니아 : boltonia
볼트 : bolt
볼트 : volt
볼트미터 : voltmeter
볼트암메트리 : voltammetry
볼트암페어 : voltampere
볼티모어 : baltimore
볼프 : wolff
봄 : bomb
봄베이 : bombay
봅슬레드 : bobsled
봉고 : bongo
부갱빌 : bougainville
부걸루 : boogaloo
부기 : boogie
부닌 : bunin
부다페스트 : budapest
부랴트 : buryat
부룬디 : burundi
부르가스 : burgas
부르고스 : burgos
부르농빌 : bournonville
부르델 : bourdelle
부르조아 : bourgeois
부르조아지 : bourgeoisie
부르주아 : bourgeois
부르크하르트 : burckhardt
부르하페 : boerhaave
부메디엔 : boumedienne
부바네스와르 : bhubaneswar
부버 : buber
부세 : busse
부셰 : boucher
부셸 : bushel
부슈 : busch
부스 : booth
부스터 : booster
부시벅 : bushbuck
부싱 : bushing
부아기유베르 : boisguillebert
부알로 : boileau
부에 : vouet
부에나벤투라 : buenaventura
부줌부라 : bujumbura
부차티 : buzzati
부코비나 : bukovina
부타졸리딘 : butazolidin
부탄 : bhutan
부탄 : butane
부트 : boot
부트스트랩 : bootstrap
부틀레로프 : butlerov
부틸 : butyl
부틸렌 : butylene
부팅 : booting
부하라 : bukhara
부하린 : bukharin
부흐 : buch
북 : book
북스 : books
분젠 : bunsen
불 : boole
불 : boulle
불가닌 : bulganin
불가코프 : bulgakov
불도그 : bulldog
불로뉴 : boulogne
불리 : bully
불린 : boleyn
불테리어 : bullterrier
불트만 : bultmann
불펜 : bullpen
붓다 : buddha
뷔데 : bud
뷔리당 : buridan
뷔야르 : vuillard
뷔퐁 : buffon
뷰글 : bugle
뷰렛 : burette
뷰어 : viewer
뷰트 : butte
브델륨 : bdellium
브라기 : bragi
브라네르 : branner
브라마굽타 : brahmagupta
브라만 : brahman
브라만테 : bramante
브라보 : bravo
브라상 : brassens
브라쇠르 : brasseur
브라우닝 : browning
브라우저 : browser
브라운 : braun
브라운 : browne
브라운슈바이크 : braunschweig
브라이디 : bridie
브라이어 : briar
브라이언 : bryan
브라이언트 : bryant
브라인 : brine
브라자 : brazza
브라자빌 : brazzaville
브라크 : braque
브라키오사우루스 : brachiosaurus
브라티슬라바 : bratislava
브란데스 : brandes
브란덴부르크 : brandenburg
브란트 : brandt
브란팅 : branting
브람 : brahm
브람스 : brahms
브래그 : bragg
브래드스트리트 : bradstreet
브래들리 : bradley
브래디키닌 : bradykinin
브래지어 : brassiere
브래키에이션 : brachiation
브래튼 : brattain
브랙턴 : bracton
브랜드 : brand
브랭귄 : brangwyn
브러더 : brother
브러시 : brush
브레다 : breda
브레디닌 : bredinin
브레멘 : bremen
브레슬라우 : breslau
브레시아 : brescia
브레이스 : brace
브레이크 : brake
브레이크 : break
브레이크슈 : brakeshoe
브레인 : braine
브레인스토밍 : brainstorming
브레주네프 : brezhnev
브레히트 : brecht
브렌타노 : brentano
브로글리 : broglie
브로드웨이 : broadway
브로드클로스 : broadcloth
브로모크립틴 : bromocriptine
브로모포름 : bromoform
브로이어 : breuer
브로치 : broach
브로치 : brooch
브로칭 : broaching
브로커 : broker
브로케이드 : brocade
브로콜리 : broccoli
브로흐 : broch
브론즈 : bronze
브론치노 : bronzino
브론토사우루스 : brontosaurus
브론토테륨 : brontotherium
브롬라이트 : bromlite
브뢰겔 : brueghel
브루게 : brugge
브루나이 : brunei
브루넬 : brunel
브루넬레스코 : brunellesco
브루넷 : brunette
브루스 : bruce
브루스터 : brewster
브루신 : brucine
브루크만 : brugmann
브루클린 : brooklyn
브루투스 : brutus
브룩 : brooke
브룬펠스 : brunfels
브룬펠시아 : brunfelsia
브뤼셀 : brussel
브뤼앙 : bruant
브뤼주 : bruges
브률로프 : bryullov
브르타뉴 : bretagne
브리간틴 : brigantine
브리그스 : briggs
브리너 : brynner
브리스틀 : bristol
브리앙 : briand
브리외 : brieux
브리지 : bridge
브리지먼 : bridgman
브리지스 : bridges
브리타니 : brittany
브리타니아 : britannia
브리튼 : britain
브리티시 : british
브리프 : briefs
브리핑 : briefing
브릴리언트 : brilliant
브이톨 : vtol
블라디미르 : vladimir
블라맹크 : vlaminck
블라바츠키 : blavatskii
블라슈 : blache
블라스티시딘 : blasticidin
블라시스 : blasis
블라우스 : blouse
블랑 : blanc
블랑샤르 : blanchard
블랑키 : blanqui
블랙 : black
블랙리스트 : blacklist
블랙베리 : blackberry
블랙아웃 : blackout
블랜타이어 : blantyre
블랭크 : blank
블러드 : blood
블러드스톤 : bloodstone
블레오마이신 : bleomycin
블레이드 : blade
블레이저 : blazer
블레이크슬리 : blakeslee
블레인 : blaine
블로 : blow
블로일러 : bleuler
블로커 : blocker
블로크 : bloch
블로킹 : blocking
블로홀 : blowhole
블로흐 : bloch
블록 : block
블론드 : blond
블롱델 : blondel
블루그래스 : bluegrass
블루길 : bluegill
블루데이지 : bluedaisy
블루멘바흐 : blumenbach
블루베리 : blueberry
블루스 : blues
블룬칠리 : bluntschli
블룸 : blum
블룸즈버리 : bloomsbury
블룸필드 : bloomfield
블리자드 : blizzard
블릭센 : blixen
비거 : vigour
비겔란 : vigeland
비고 : vigo
비글 : beagle
비긴 : beguine
비너스 : venus
비노그라도프 : vinogradoff
비뇰라 : vignola
비니 : vigny
비니언 : binyon
비니온 : vinyon
비닐 : vinyl
비닐리덴 : vinylidene
비달 : widal
비더 : vidor
비들 : beadle
비디오 : video
비디오디스크 : videodisk
비디오카메라 : videocamera
비디오텍스 : videotex
비디콘 : vidicon
비르 : birr
비르타넨 : virtanen
비리디언 : viridian
비발디 : vivaldi
비밥 : bebop
비버 : beaver
비베스 : vives
비브라폰 : vibraphone
비비에나 : bibiena
비샤 : bichat
비센테 : vicente
비숍 : bishop
비스 : bis
비스마르크 : bismarck
비스모터 : bismotor
비스카리아 : viscaria
비스카차 : viscacha
비스코스 : viscose
비스킷 : biscuit
비스타 : vista
비스터 : bister
비시 : vichy
비시툰 : bisitun
비신스키 : vyshinskii
비어드 : beard
비어스 : bierce
비에니아프스키 : wieniawski
비엔나 : vienna
비엔날레 : biennale
비오 : biot
비오 : viau
비오스 : bios
비오틴 : biotin
비오페르민 : biofermin
비온 : bion
비외탕 : vieuxtemps
비용 : villon
비이클 : vehicle
비잔티움 : byzantium
비저 : wieser
비전 : vision
비주얼 : visual
비즈 : beads
비즈니스 : business
비즈마크 : bismarck
비첨 : beecham
비츠 : witz
비카네르 : bikaner
비커 : beaker
비컨 : beacon
비키니 : bikini
비타민 : vitamin
비탈륨 : vitallium
비테 : vitte
비텐베르크 : wittenberg
비텔린 : vitellin
비트 : beat
비트 : beet
비트 : bit
비트루비우스 : vitruvius
비트바테르스란트 : witwatersrand
비티히 : wittig
비페닐 : biphenyl
비피나리아 : bipinnaria
비헤르트 : wiechert
빅 : big
빅 : vic
빅토리 : victory
빅토리아 : victoria
빅토리아니즘 : victorianism
빈 : bean
빈 : wien
빈다우스 : windaus
빈딩 : binding
빈스방거 : binswanger
빈치 : vinci
빈투롱 : binturong
빈트후크 : windhoek
빈티지 : vintage
빌게 : bilge
빌나 : vilna
빌더 : builder
빌딩 : building
빌라 : vila
빌라 : villa
빌라르트 : willaert
빌란트 : wieland
빌레이 : belay
빌렘스타트 : willemstad
빌리루빈 : bilirubin
빌리베르딘 : biliverdin
빌리켄 : billiken
빌림비 : bilimbi
빌릿 : billet
빌헬름 : wilhelm
빌헬미나 : wilhelmina
빙고 : bingo
빙켈만 : winckelmann
빙클러 : winkler
사고 : sago
사그라다 : sagrada
사나 : sanaa
사닌 : sanin
사다트 : sadat
사도닉스 : sardonyx
사드 : sade
사드코 : sadko
사디스트 : sadist
사라 : sarah
사라가트 : saragat
사라고사 : zaragoza
사라사테 : sarasate
사라세니아 : sarracenia
사라센 : saracen
사라예보 : sarajevo
사라와크 : sarawak
사라토프 : saratov
사란스크 : saransk
사로스 : saros
사로얀 : saroyan
사르곤 : sargon
사르나트 : sarnath
사르데냐 : sardegna
사르디스 : sardis
사르마트 : sarmat
사르마티아 : sarmatia
사르코글리아 : sarcoglia
사르코마이신 : sarcomycin
사르코신 : sarcosine
사르토 : sarto
사르트 : sart
사르트르 : sartre
사리넨 : saarinen
사리얀 : sariyan
사마라 : samara
사마르칸트 : samarkand
사마리아 : samaria
사맹 : samain
사모예드 : samoyed
사무엘 : samuel
사바나 : savanna
사바스 : sabbath
사바티에 : sabatier
사방 : sabang
사보이 : savoy
사부아 : savoie
사비니 : savigny
사비트르 : savitr
사빈코프 : savinkov
사사프라스 : sassafras
사양 : saillant
사우나 : sauna
사우디 : southey
사우스 : south
사우스포 : southpaw
사운드 : sound
사웅 : saung
사워 : sour
사이공 : saigon
사이다 : saida
사이드 : side
사이드라인 : sideline
사이드스트로크 : sidestroke
사이드슬립 : sideslip
사이드아웃 : sideout
사이드카 : sidecar
사이러트론 : thyratron
사이렌 : siren
사이멀캐스트 : simulcast
사이밍턴 : symingston
사이보그 : cyborg
사이언스 : science
사이즈 : size
사이코그래프 : psychograph
사이코그래피 : psychography
사이코드라마 : psychodrama
사이클 : cycle
사이클로세린 : cycloserine
사이클로스포린 : cyclosporine
사이클로트론 : cyclotron
사이클로프로판 : cyclopropan
사이클론 : cyclone
사이키 : psyche
사이키델릭 : psychedelic
사이토카인 : cytokine
사이트 : site
사이펀 : siphon
사이페르트 : seifert
사인 : sign
사인 : sine
사일로 : silo
사전트 : sargent
사조노프 : sazonov
사카라 : saqqara
사카린 : saccharin
사케리 : saccheri
사케티 : sacchetti
사탄 : satan
사턴 : sarton
사투르누스 : saturnus
사파이어 : sapphire
사파타 : zapata
사포 : sappho
사포딜라 : sapodilla
사프롤 : safrole
사피즘 : sapphism
사하 : sakha
사하란푸르 : saharanpur
사할린 : sakhalin
삭소 : saxo
산 : san
산다락 : sandarac
산다칸 : sandakan
산세비에리아 : sansevieria
산스크리트 : sanskrit
산자 : sanza
산초 : sancho
산타 : santa
산타야나 : santayana
산탄데르 : santander
산토닌 : santonin
산토리오 : santorio
산투스 : santos
산플라티나 : sanplatina
살라딘 : saladin
살라망카 : salamanca
살라미스 : salamis
살라자르 : salazar
살람보 : salammb
살레르노 : salerno
살레유 : saleilles
살레지오 : salesio
살렙 : salep
살로그 : sallog
살로메 : salom
살롱 : salon
살루스티우스 : sallustius
살루키 : saluki
살리게닌 : saligenin
살리나 : salina
살리에리 : salieri
살리타 : salietai
살릭 : salic
살바도르 : salvador
살바르산 : salvarsan
살부타몰 : salbutamol
살솔린 : salsoline
살코 : salchow
살타 : salta
살파 : salpa
삼마르티니 : sammartini
삼바 : samba
상갈로 : sangallo
상드 : sand
상드라르 : cendrars
새너토리엄 : sanatorium
새들 : saddle
새러토가 : saratoga
새커리 : thackeray
새크라멘토 : sacramento
새크러먼트 : sacrament
새틴 : satin
색 : sac
색 : sack
색스 : sax
색스니 : saxony
색스혼 : saxhorn
샌드 : sand
샌드백 : sandbag
샌드버그 : sandburg
샌드위치맨 : sandwichman
샌드케이 : sandcay
샌들 : sandal
샌포라이즈드 : sanforized
샐러드 : salad
샐러맨더 : salamander
샐비지 : salvage
샘 : sam
샘팬 : sampan
샘플링 : sampling
생어 : sanger
생크추어리 : sanctuary
샤기냔 : shaginyan
샤넬 : chanel
샤도 : schadow
샤롱 : charron
샤르 : char
샤르댕 : chardin
샤르돈 : chardonne
샤르코 : charcot
샤르트르 : chartres
샤르팡티에 : charpentier
샤른호르스트 : scharnhorst
샤를 : charles
샤머니즘 : shamanism
샤먼 : shaman
샤미소 : chamisso
샤브리에 : chabrier
샤스탕 : chastan
샤스트리 : shastri
샤워 : shower
샤이데만 : scheidemann
샤이엔 : cheyenne
샤일록 : shylock
샤카 : shaka
샤크스킨 : sharkskin
샤토브리앙 : chateaubriand
샤프 : chappe
샤프 : sharp
샤프트 : shaft
샤흐트 : schacht
샨 : shahn
샴페인 : champagne
샴푸 : shampoo
샹송 : chamson
샹파뉴 : champagne
샹폴리옹 : champollion
샹플뢰리 : champfleury
섀그 : shag
섀도 : shadow
섀미 : chamois
섀시 : chassis
섀시 : shassis
섀프츠베리 : shaftesbury
섀플리 : shapley
섄디 : shandy
서드베리 : sudbury
서든 : sudden
서리 : surrey
서머힐 : summerhill
서멀 : thermal
서멧 : cermet
서모스탯 : thermostat
서모콘크리트 : thermoconcrete
서미스터 : thermistor
서버 : server
서버 : thuber
서베이 : survey
서베일런스 : serveillance
서보 : servo
서브 : serve
서브도미넌트 : subdominant
서브루틴 : subroutine
서브미사일 : submissile
서브스키마 : subschema
서브스턴스 : substance
서브스테이션 : substation
서브타이틀 : subtitle
서블리그 : therblig
서빙 : serving
서순 : sassoon
서스테이닝 : sustaining
서스펜션 : suspension
서스펜스 : suspense
서식스 : sussex
서지 : surge
서징 : surging
서커 : sucker
서커스 : circus
서큘러 : circular
서클 : circle
서턴 : sutton
서티 : thirty
서포터 : supporter
서프레스 : suppress
서플라이 : supply
서피스 : surface
선드레스 : sundress
선루프 : sunroof
선룸 : sunroom
선셰이드 : sunshade
선탠 : suntan
설로인 : sirloin
설리번 : sullivan
설바나이트 : sulvanite
설피린 : sulpyrine
세 : say
세간티니 : segantini
세게드 : szeged
세고비아 : segovia
세그레 : segr
세그먼테이션 : segmentation
세네가 : senega
세네갈 : senegal
세니 : segni
세단 : sedan
세라르지라이트 : cerargyrite
세라믹 : ceramics
세라믹스 : ceramics
세라오 : serao
세라핌 : seraphim
세레나데 : serenade
세레스 : seres
세로토닌 : serotonin
세루사이트 : cerussite
세륨 : cerium
세르베투스 : servetus
세르비아 : serbia
세르카리아 : cercaria
세른 : cern
세를리오 : serlio
세리신 : sericin
세리프 : serif
세린 : serine
세망 : semang
세멜레 : semele
세묘노프 : semyonov
세미나 : seminar
세미다큐멘터리 : semidocumentary
세미스틸 : semisteel
세미케미컬 : semichemical
세미톤 : semitone
세미파이널 : semifinal
세미팔라틴스크 : semipalatinsk
세베리니 : severini
세부 : cebu
세브카 : sebka
세비야 : sevilla
세션 : session
세슘 : cesium
세오돌라이트 : theodolite
세우타 : ceuta
세이렌 : seiren
세이버 : saber
세이버리 : savery
세이블 : sable
세이빙 : saving
세이셸 : seychelles
세이스 : sayce
세이프 : safe
세이프티 : safety
세인츠버리 : saintsbury
세인트폴리아 : saintpaulia
세일 : sale
세일러 : theiler
세일즈 : sales
세일즈맨 : salesman
세컨드 : second
세쿼이아 : sequoia
세크 : sec
세크레틴 : secretin
세타 : theta
세탄 : cetane
세터 : setter
세트 : set
세틀먼트 : settlement
세팅 : setting
세파만돌 : cefamandole
세파졸린 : cefazolin
세팍타크로 : sepaktakraw
세팔로스포린 : cephalosporin
세팔린 : cephalin
세퍼레이츠 : separates
세포탁심 : cefotaxime
세포페라존 : cefoperazone
세프라딘 : cephradine
세피아 : sepia
섹셔널 : sectional
섹스 : sex
섹스턴트 : sextant
섹스텟 : sextet
섹터 : sector
센나 : senna
센달로이 : sendalloy
센서 : sensor
센서스 : census
센스 : sense
센싱 : sensing
센타우레아 : centaurea
센터 : center
센터링 : centering
센텐스 : sentence
센토 : centaur
센트 : cent
센트럴 : central
센트로이드 : centroid
센티리터 : centiliter
센티미터 : centimeter
셀 : cell
셀라 : sela
셀라시에 : selassie
셀러리 : celery
셀레늄 : selenium
셀레우키아 : seleukia
셀로 : celo
셀로얀 : celloyarn
셀로텍스 : celotex
셀로판 : cellophane
셀룰로오스 : cellulose
셀룰로이드 : celluloid
셀리그먼 : seligman
셀바스 : selvas
셀신 : selsyn
셀프 : self
셈 : sem
셉 : cep
셔링 : shirring
셔먼 : sherman
셔벗 : sherbet
셔우드 : sherwood
셔츠 : shirt
셔터 : shutter
셔틀콕 : shuttlecock
셔플 : shuffle
션트 : shunt
셜리 : shirley
셧아웃 : shutout
셰러턴 : sheraton
셰르파 : sherpa
셰르헨 : scherchen
셰리 : sherry
셰리프 : sherriff
셰링 : szeryng
셰링턴 : sherrington
셰어 : share
셰에라자드 : scheherazade
셰이드 : shade
셰이크 : shake
셰이크 : sheik
셰이퍼 : shaper
셰익스피어 : shakespeare
셰일 : shale
셰퍼드 : shepherd
셰프 : chef
셰프첸코 : shevchenko
셰필드 : sheffield
셸락 : shellac
셸러 : scheler
셸링 : schelling
셸번 : shelburne
셸터드 : sheltered
소그디아나 : sogdiana
소나 : sonar
소나그래프 : sonagraph
소나타 : sonata
소네트 : sonnet
소노그래프 : sonograph
소노미터 : sonometer
소노부이 : sonobuoy
소노시트 : sonosheet
소다 : soda
소도마 : sodoma
소돔 : sodom
소드테일 : swordtail
소드피시 : swordfish
소디 : soddy
소렌토 : sorrento
소렐 : sorel
소로 : thoreau
소로킨 : sorokin
소르 : sor
소르바이트 : sorbite
소른 : zorn
소마데바 : somadeva
소마토스타틴 : somatostatin
소말릴란드 : somaliland
소브레로 : sobrero
소비에트 : soviet
소서스 : sosus
소셔그룹 : sociogroup
소셔드라마 : sociodrama
소셜 : social
소쉬르 : saussure
소스 : sauce
소스노비에츠 : sosnowiec
소시오그램 : sociogram
소시지 : sausage
소켓 : socket
소크 : salk
소크라테스 : socrates
소팅 : sorting
소포클레스 : sophocles
소프라노 : soprano
소프트 : soft
소프트노믹스 : softnomics
소프트볼 : softball
소피스트 : sophist
소피아 : sofia
소피아 : sophia
손디 : szondi
솔 : sole
솔 : soul
솔라리제이션 : solarization
솔레노돈 : solenodon
솔레노이드 : solenoid
솔로 : solo
솔로구프 : sologub
솔로몬 : solomon
솔리드 : solid
솔리톤 : soliton
솔립시즘 : solipsism
솔베이 : solvay
솔즈베리 : salisbury
솔트 : salt
쇠라 : seurat
쇼 : shaw
쇼 : show
쇼랜 : shoran
쇼룸 : showroom
쇼맨 : showman
쇼비니즘 : chauvinism
쇼송 : chausson
쇼크 : shock
쇼클리 : shockley
쇼탕 : chautemps
쇼트 : shot
쇼트닝 : shortening
쇼트스톱 : shortstop
쇼트헤어 : shorthair
쇼팽 : chopin
쇼펜하우어 : schopenhauer
숀 : shawn
숀가우어 : schongauer
숄 : shawl
숄라푸르 : sholapur
숄로호프 : sholokhov
숄스 : sholes
숍 : shop
숏 : shot
수단 : sudan
수라바야 : surabaja
수라카르타 : surakarta
수라트 : surat
수리남 : surinam
수리아 : surya
수리코프 : surikov
수메르 : sumer
수미티온 : sumithion
수바 : suva
수사 : susa
수슬로프 : suslov
수에즈 : suez
수오미 : suomi
수자 : sousa
수자폰 : sousaphone
수코타이 : sukhothai
수크로오스 : sucrose
수포 : soupault
수프 : soup
수플로 : soufflot
수피즘 : sufism
수후미 : sukhumi
숙시닐콜린 : succinylcholine
술린닥 : sulindac
술탄 : sultan
술파구아니딘 : sulfaguanidine
술파다이아진 : sulfadiazine
술파다이어졸 : sulfathiazole
술파메티졸 : sulfametizole
술파피리딘 : sulfapyridine
술포날 : sulfonal
술포닐 : sulfonyl
술폰아미드 : sulfonamide
술피소미딘 : sulfisomidine
술피속사졸 : sulfisoxazole
쉬망 : schuman
쉬페르비엘 : supervielle
쉴리 : sully
슈나벨 : schnabel
슈니츨러 : schnitzler
슈도다나 : uddhodana
슈도코드 : pseudocode
슈라우드 : shroud
슈렁크 : shrunk
슈마허 : schumacher
슈만 : schumann
슈말렌바흐 : schmalenbach
슈미데베르크 : schmiedeberg
슈미트 : schmidt
슈미트 : schmitt
슈바르츠발트 : schwarzwald
슈바르츠실트 : schwarzschild
슈바프 : schwab
슈반 : schwann
슈발리에 : chevalier
슈벵크펠트 : schwenkfeld
슈비터스 : schwitters
슈빈트 : schwind
슈어드 : seward
슈얼 : sewell
슈즈 : shoes
슈클로프스키 : shklovskii
슈타르크 : stark
슈타미츠 : stamitz
슈타우트 : staudt
슈타우피츠 : staupitz
슈타이너 : steiner
슈타인하일 : steinheil
슈탈 : stahl
슈탐러 : stammler
슈테른 : stern
슈테판 : stefan
슈토름 : storm
슈투트가르트 : stuttgart
슈툼프 : stumpf
슈트 : chute
슈트라스만 : strassmann
슈트라스부르거 : strasburger
슈트라우스 : strauss
슈트로하임 : stroheim
슈티르너 : stirner
슈티프터 : stifter
슈파이어 : speyer
슈퍼 : super
슈퍼리얼리즘 : superrealism
슈퍼맨 : superman
슈퍼비전 : supervision
슈퍼세션 : supersession
슈퍼스타 : superstar
슈퍼스테이션 : superstation
슈퍼에고 : superego
슈퍼컴퓨터 : supercomputer
슈퍼탱커 : supertanker
슈퍼히터 : superheater
슈페만 : spemann
슈펠트 : shufeldt
슈펭글러 : spengler
슈프랑거 : spranger
슈프렝겔 : sprengel
슈피리 : spyri
슐라이덴 : schleiden
슐라이어마허 : schleiermacher
슐라이허 : schleicher
슐레겔 : schlegel
슐레스비히 : schleswig
슐레지엔 : schlesien
슐리크 : schlick
슐체 : schultze
슘페터 : schumpeter
스내치 : snatch
스낵 : snack
스냅 : snap
스네이크우드 : snakewood
스넬 : snell
스노 : snow
스노든 : snowden
스노리 : snorri
스노모빌 : snowmobile
스노볼 : snobol
스노블로어 : snowblower
스노홀 : snowhole
스라파 : sraffa
스러스터 : thruster
스러스트 : thrust
스루 : through
스리 : three
스리비자야 : srivijaya
스리섬 : threesome
스릴러 : thriller
스매시 : smash
스매싱 : smashing
스머더 : smother
스메타나 : smetana
스멜리 : smellie
스멜필름 : smellfilm
스모크 : smoke
스모킹 : smocking
스목 : smock
스몰 : small
스몰렌스크 : smolensk
스몰렛 : smollett
스무드 : smooth
스미르나 : smyrna
스미소나이트 : smithonite
스미턴 : smeaton
스베덴보리 : swedenborg
스베드베리 : svedberg
스베르들로프스크 : sverdlovsk
스베보 : svevo
스벤손 : svensson
스와질란드 : swaziland
스와트 : swat
스완지 : swansea
스웨덴 : sweden
스웨이 : sway
스웨이드 : suede
스웨잉 : swaying
스웨터 : sweater
스웨팅 : sweating
스위스 : suisse
스위치백 : switchback
스위트 : suite
스위트 : sweet
스위퍼 : sweeper
스윈번 : swinburne
스윔 : swim
스윙 : swing
스카 : scar
스카롱 : scarron
스카를라티 : scarlatti
스카시 : scsi
스카우트 : scout
스카우트 : scouts
스카이다이버 : skydiver
스카이다이빙 : skydiving
스카이라인 : skyline
스카이훅 : skyhook
스카폴라이트 : scapolite
스카프 : scarf
스칼라 : scalar
스칼러십 : scholarship
스칼리제르 : scaliger
스캐닝 : scanning
스캐브 : scab
스캐빈저 : scavenger
스캔런 : scanlon
스캘럽 : scallop
스캣 : scat
스컬 : scull
스컬 : sculls
스컬프처 : sculpture
스케이트 : skate
스케이트보드 : skateboard
스케이팅 : skating
스케일링 : scaling
스케줄 : schedule
스코리어 : scoria
스코어 : score
스코어링 : scoring
스코어보드 : scoreboard
스코어북 : scorebook
스코치 : scotch
스코틀랜드 : scotland
스코파스 : scopas
스코페 : skopje
스코프 : scope
스코필드 : scofield
스콜 : squall
스콧 : scott
스콸렌 : squalene
스쿠너 : schooner
스쿠터 : scooter
스쿨 : school
스쿨링 : schooling
스퀘어 : square
스퀴브 : squib
스퀴즈 : squeeze
스큐 : skew
스크라이버 : scriber
스크라이빙 : scribing
스크래피 : scrapie
스크랜턴 : scranton
스크램블 : scramble
스크랩북 : scrapbook
스크랴빈 : skryabin
스크러미지 : scrummage
스크레이퍼 : scraper
스크롤 : scroll
스크루 : screw
스크리닝 : screening
스크리미지 : scrimmage
스크리브 : scribe
스크립터 : scripter
스크립트 : script
스키 : ski
스키마 : schema
스키아파렐리 : schiaparelli
스키오그래프 : skiograph
스키타이 : skythai
스키피스토마 : scyphistoma
스키피오 : scipio
스킥다 : skikda
스킨 : skin
스킬 : skill
스타 : star
스타니슬라프스키 : stanislavskii
스타덤 : stardom
스타보드 : starboard
스타브로폴 : stavropol
스타우트 : stout
스타이컨 : steichen
스타인 : stein
스타인메츠 : steinmetz
스타인벡 : steinbeck
스타일 : style
스타일리스트 : stylist
스타일북 : stylebook
스타킹 : stocking
스타터 : starter
스타티세 : statice
스타팅 : starting
스타펠리아 : stapelia
스탈리노 : stalino
스탈린 : stalin
스탈린그라드 : stalingrad
스탈링 : starling
스탕달 : stendhal
스태그플레이션 : stagflation
스태빌라이저 : stabilizer
스태커 : stacker
스태프 : staff
스택 : stack
스탠더드 : standard
스탠딩 : standing
스탠리 : stanley
스탠리빌 : stanleyville
스탠자 : stanza
스탠턴 : stanton
스탬프 : stamp
스턴 : sterne
스턴버그 : sternberg
스턴트 : stunt
스테고돈 : stegodon
스테고사우루스 : stegosaurus
스테노 : steno
스테레오 : stereo
스테로이드 : steroid
스테롤 : sterol
스테빈 : stevin
스테아린 : stearin
스테압신 : steapsin
스테이션 : station
스테이지 : stage
스테이크 : steak
스테이트 : state
스테이플 : staple
스테인리스 : stainless
스텐실 : stencil
스텐카 : stenka
스텔라이트 : stellite
스텝 : step
스텝 : steppe
스토 : stowe
스토니 : stony
스토리빌 : storyville
스토이시즘 : stoicism
스토커 : stoker
스토케시아 : stokesia
스토크스 : stokes
스토퍼 : stopper
스토피지 : stoppage
스톡 : stock
스톡홀름 : stockholm
스톤 : stone
스톨 : stall
스톨 : stol
스톨 : stole
스톱 : stop
스투파 : stupa
스툴 : stool
스튜 : stew
스튜디오 : studio
스튜어드 : steward
스튜어트 : stewart
스튜어트 : stuart
스트라디바리 : stradivari
스트라빈스키 : stravinsky
스트라스부르 : strasbourg
스트라이드 : stride
스트라이크 : strike
스트라이킹 : striking
스트래퍼드 : strafford
스트레이트 : straight
스트레인 : strain
스트레인지니스 : strangeness
스트레칭 : stretching
스트렙토마이신 : streptomycin
스트렙토미세스 : streptomyces
스트로 : straw
스트로마 : stroma
스트로보스코프 : stroboscope
스트로빌라 : strobila
스트로크 : stroke
스트로판틴 : strophanthin
스트로풀루스 : strophulus
스트론튬 : strontium
스트리콤 : stricom
스트리크닌 : strychnine
스트리킹 : streaking
스트리퍼 : stripper
스트린드베리 : strindberg
스트립 : strip
스티글리츠 : stieglitz
스티렌 : styrene
스티로폼 : styrofoam
스티븐스 : stevens
스티븐슨 : stephenson
스티븐슨 : stevenson
스티치 : stich
스티치 : stitch
스틱 : stick
스틸 : steel
스틸 : steele
스틸 : still
스틸바이트 : stilbite
스틸브 : stilb
스팀 : steam
스파다츠 : spadats
스파르타 : sparta
스파르타쿠스 : spartacus
스파링 : sparring
스파이 : spy
스파이럴 : spiral
스파이커 : spiker
스파이크 : spike
스파커 : sparker
스파크 : spark
스팍스 : sfax
스판덱스 : spandex
스패너 : spanner
스패니얼 : spaniel
스패츠 : spats
스팽글 : spangle
스퍼 : spur
스퍼트 : spurt
스펀지 : sponge
스페노돈 : spenodon
스페란스키 : speranski
스페로플라스트 : spheroplast
스페르마틴 : spermatin
스페릭스 : spherics
스페우시포스 : speusippos
스페이드 : spade
스페이스 : space
스페큘럼 : speculum
스펙트럼 : spectrum
스펙트로그래프 : spectrograph
스펙트로미터 : spectrometer
스펙트로스코프 : spectroscope
스펙트로헬리오그래프 : spectroheliograph
스펠 : spell
스펠링 : spelling
스포로시스트 : sporocyst
스포츠 : sports
스포츠맨 : sportsman
스포캔 : spokane
스폰서 : sponsor
스폰티니 : spontini
스폿 : spot
스풀링 : spooling
스프레드시트 : spreadsheet
스프로킷 : sproket
스프링 : spring
스프링보드 : springboard
스프링클러 : sprinkler
스프링필드 : springfield
스플라인 : spline
스플리트 : split
스플릿 : split
스피너 : spinner
스피넷 : spinet
스피노자 : spinoza
스피드 : speed
스피로놀락톤 : spironolactone
스피로지라 : spirogyra
스피로헤타 : spirochaeta
스피릴룸 : spirillum
스피릿 : spirit
스피어민트 : spearmint
스피카 : spica
스피커 : speaker
스피커폰 : speakerphone
스핀 : spin
스핀들 : spindle
스핀새리스코프 : spinthariscope
스핏볼 : spitball
스핑고미엘린 : sphingomyelin
스핑크스 : sphinx
슬라이드 : slide
슬라이딩 : sliding
슬라이스 : slice
슬래브 : slab
슬래시 : slash
슬랙스 : slacks
슬랩스틱 : slapstick
슬랭 : slang
슬러거 : slugger
슬러리 : slurry
슬럼 : slum
슬럼프플레이션 : slumpflation
슬레이크 : slake
슬레이트 : slate
슬로건 : slogan
슬로바키아 : slovakia
슬로베니아 : slovenia
슬로팅 : slotting
슬롯 : slot
슬뤼테르 : sluter
슬리브 : sleeve
슬리브리스 : sleeveless
슬리커 : slicker
슬리퍼 : slipper
슬립 : slip
슬릿 : slit
시 : sea
시가 : cigar
시게티 : szigeti
시그마트론 : sigmatron
시그반 : siegbahn
시기리야 : sigiriya
시나몬 : cinnamon
시냅스 : synapse
시냐크 : signac
시너고그 : synagogue
시네라리아 : cineraria
시네라마 : cinerama
시네마컬러 : cinemacolor
시네마토그래프 : cinematograph
시네스코 : cinesco
시뇨렐리 : signorelli
시니시즘 : cynicism
시니어 : senior
시더 : cedar
시데로스탯 : siderostat
시드 : seed
시드넘 : sydenham
시드니 : sidney
시라쿠사 : siracusa
시러큐스 : syracuse
시리아 : syria
시리즈 : series
시링크스 : syrinx
시마 : sima
시머 : symmer
시먼스 : symons
시먼즈 : symonds
시멘타이트 : cementite
시멘테이션 : cementation
시멘트 : cement
시모스 : cmos
시몬 : simon
시몰라이트 : cimolite
시뭄 : simoom
시뮬레이션 : simulation
시뮬레이터 : simulator
시바 : iva
시바스 : sivas
시바피테쿠스 : sivapithecus
시베리아 : siberia
시벡스 : civex
시벨리우스 : sibelius
시빅 : civic
시빌 : civil
시사프라이드 : cisapride
시소 : seesaw
시소러스 : thesaurus
시스몽디 : sismondi
시스템 : system
시스템 : systems
시스템스 : systems
시스플라틴 : cisplatin
시슬레 : sisley
시시포스 : sisyphos
시아나이드 : cyanide
시아노겐 : cyanogen
시아노아세틸렌 : cyanoacetylene
시아닌 : cyanin
시안아미드 : cyanamide
시알 : sial
시암 : siam
시애틀 : seattle
시어링 : shearing
시어터 : theater
시어터 : theatre
시어트리컬리즘 : theatricalism
시에나 : siena
시엔키에비치 : sienkiewicz
시엔푸에고스 : cienfuegos
시온 : zion
시이즘 : theism
시저 : caesar
시지 : siege
시지윅 : sidgwick
시체드린 : shchedrin
시쳅킨 : shchepkin
시추에이션 : situation
시칠리아 : sicilia
시컨트 : secant
시케이로스 : siqueiros
시켈레 : schickele
시코르스키 : sikorsky
시쿠삭 : sikussak
시퀀스 : sequence
시클라멘 : cyclamen
시클로바르비탈 : cyclobarbital
시클로알칸 : cycloalkane
시클로판 : cyclopan
시클로펜탄 : cyclopentane
시턴 : seton
시토 : seato
시토신 : cytosine
시토키닌 : cytokinin
시트 : seat
시트 : sheet
시트로넬롤 : citronellol
시트론 : citron
시트룰린 : citrulline
시트콤 : sitcom
시티 : city
시티딘 : cytidine
시폰 : chiffon
시프로테론 : siproteron
시프트 : shift
신 : scene
신데렐라 : cinderella
신드롬 : syndrome
신디케이트 : syndicate
신시내티 : cincinnati
신시사이저 : synthesizer
신티그램 : scintigram
신티스캐닝 : scintiscanning
신틸레이션 : scintillation
실 : sill
실드 : shield
실란 : silane
실러 : schiller
실러캔스 : coelacanth
실레 : schiele
실렉터 : selector
실로네 : silone
실로미터 : ceilometer
실로폰 : xylophone
실롱 : shillong
실루엣 : silhouette
실리마린 : silymarin
실리사이드 : silicide
실리콘 : silicon
실리콘 : silicone
실린더 : cylinder
실링 : schilling
실링 : shilling
실바 : silva
실버 : silver
실버톤 : silverton
실베스터 : sylvester
실크 : silk
실트 : silt
심벌 : cymbal
심벌리즘 : symbolism
심벌릭 : symbolic
심벌즈 : cymbals
심페로폴 : simferopol
심포니 : symphony
심포닉 : symphonic
심프슨 : simpson
심플론 : simplon
십 : ship
싱가포르 : singapore
싱글 : single
싱어 : singer
싱커페이션 : syncopation
싱켈 : schinkel
싱크로 : synchro
싱크로나이즈드 : synchronized
싱크로스코프 : synchroscope
싱크로트론 : synchrotron
싱클레어 : sinclair
아가 : agar
아가시 : agassiz
아가판투스 : agapanthus
아게라툼 : ageratum
아구다 : aguda
아구티 : agouti
아그네스 : agnes
아그니 : agni
아그라 : agra
아그람 : agram
아그리젠토 : agrigento
아그리콜라 : agricola
아그리파 : agrippa
아글리콘 : aglycone
아기날도 : aguinaldo
아나나스 : ananas
아나콘다 : anaconda
아나크레온 : anacreon
아나크로니즘 : anachronism
아나키즘 : anarchism
아나톡신 : anatoxin
아나톨 : anatole
아나폴리스 : annapolis
아낙사고라스 : anaxagoras
아낙시만드로스 : anaximandros
아난다 : ananda
아날긴 : analgin
아날로그 : analogue
아널드 : arnold
아네로이드 : aneroid
아네모네 : anemone
아노님 : anonym
아노락 : anorak
아노말로스코프 : anomaloscope
아노펠레스 : anopheles
아농 : hanon
아누 : anu
아누비스 : anubis
아누이 : anouilh
아니솔 : anisole
아니시딘 : anisidine
아닐리드 : anilide
아닐린 : aniline
아다마르 : hadamard
아다모프 : adamov
아다파 : adapa
아당 : adam
아데나워 : adenauer
아데노바이러스 : adenovirus
아데노이드 : adenoid
아데닌 : adenine
아데르민 : adermin
아도니스 : adonis
아도르노 : adorno
아도름 : adorm
아드레날린 : adrenaline
아드레노크롬 : adrenochrome
아드리아노플 : adrianople
아들러 : adler
아디놀 : adinole
아디안툼 : adiantum
아디티 : aditi
아라고 : arago
아라고나이트 : aragonite
아라니아카 : aranyaka
아라드 : arad
아라비 : arabi
아라비스탄 : arabistan
아라비아 : arabia
아라비안 : arabian
아라크네 : arachne
아라토스 : aratos
아란티우스 : arantius
아레니우스 : arrhenius
아레스 : ares
아레키파 : arequipa
아레티노 : aretino
아렌스키 : arensky
아로마라마 : aromarama
아로와나 : arowana
아론 : aaron
아룬타 : arunta
아르 : are
아르갈리 : argali
아르겔란더 : argelander
아르고스 : argos
아르곤 : argonne
아르기닌 : arginine
아르노 : arnauld
아르놀드손 : arnoldson
아르님 : arnim
아르덴 : ardennes
아르디 : hardy
아르마딜로 : armadillo
아르메니아 : armenia
아르메리아 : armeria
아르보 : arbeau
아르보바이러스 : arbovirus
아르보스 : arbos
아르스페나민 : arsphenamine
아르자마스 : arzamas
아르치바셰프 : artsybashev
아르카디우스 : arcadius
아르카스 : arcas
아르코사이트 : arkosite
아르크투루스 : arcturus
아르키메데스 : archimedes
아르키펭코 : archipenko
아르테미스 : artemis
아르퉁 : hartung
아르헨티나 : argentina
아른트 : arndt
아른헴 : arnhem
아를베르크 : arlberg
아리만 : ahriman
아리스타르코스 : aristarchos
아리스토파네스 : aristophanes
아리스티데스 : aristides
아리스티포스 : aristippos
아리안 : aryan
아리엘 : ariel
아리오스토 : ariosto
아리우스 : arius
아리카 : arica
아리크부카 : arikbukha
아마릴리스 : amaryllis
아마야 : amaya
아마조니아 : amazonia
아마추어 : amateur
아마추어 : armature
아마추어리즘 : amateurism
아말감 : amalgam
아머리 : armory
아메리고 : amerigo
아메리카 : america
아메리칸 : american
아메바 : amoeba
아멘 : amen
아모르 : amor
아모바비탈 : amobarbital
아모이 : amoy
아목시실린 : amoxicillin
아몬 : amon
아몽통 : amontons
아문센 : amundsen
아미노 : amino
아미노돈 : amynodon
아미노메트라딘 : aminometradine
아미노페놀 : aminophenol
아미노피린 : aminopyrine
아미노필린 : aminophylline
아미드 : amide
아미딘 : amidine
아미세틴 : amicetin
아미앵 : amiens
아미엘 : amiel
아미오다론 : amiodarone
아미카신 : amikacin
아민 : amine
아밀렌 : amylene
아밀로이드 : amyloid
아밀로펙틴 : amylopectin
아밀롭신 : amylopsin
아바나 : havana
아바단 : abadan
아바쿰 : avvakum
아베나리우스 : abenarius
아베날린 : avenalin
아베베 : abebe
아베오쿠타 : abeokuta
아베크 : abegg
아베크 : avec
아벨 : abell
아보가드로 : avogadro
아보그램 : avogram
아브라함 : abraham
아브람 : abram
아브루치 : abruzzi
아비도스 : abydos
아비센나 : avicenna
아비시니아 : abyssinia
아비장 : abidjan
아사신 : assassin
아샤르 : achard
아세나프틸렌 : acenaphthylene
아세르 : asser
아세안 : asean
아세테이트 : acetate
아세토페논 : acetophenone
아세톤 : acetone
아세트아미노펜 : acetaminophen
아세트아미드 : acetamide
아세트알데히드 : acetaldehyde
아세틸렌 : acetylene
아세틸콜린 : acetylcholine
아소카 : asoka
아슈르 : ashur
아슈르바니팔 : ashurbanipal
아슈타르테 : ashtarte
아스록 : asroc
아스마라 : asmara
아스만 : assmann
아스완 : aswan
아스카리돌 : ascaridole
아스케 : aske
아스키 : ascii
아스타일 : astile
아스타틴 : astatine
아스테록실론 : asteroxylon
아스투리아스 : asturias
아스트로비전 : astrovision
아스파라거스 : asparagus
아스파라긴 : asparagine
아스파르템 : asparteme
아스팔트 : asphalt
아스피레이터 : aspirator
아스피린 : aspirin
아시리아 : assyria
아시스 : assis
아시아 : asia
아시안 : asian
아아흐메스 : aahmes
아야 : aya
아에기르 : aegir
아옌데 : allende
아우구스티누스 : augustinus
아우라민 : auramine
아우랑제브 : aurangzeb
아우렐리우스 : aurelius
아우로라 : aurora
아우리쿨라리아 : auricularia
아우슈비츠 : auschwitz
아우스터리츠 : austerlitz
아우어 : auer
아우엔브루거 : auenbrugger
아우크스부르크 : augsburg
아우트라이트 : outright
아우트리거 : outrigger
아웃 : out
아웃도어 : outdoor
아웃보드 : outboard
아웃사이더 : outsider
아웃사이드 : outside
아웃커브 : outcurve
아웃풋 : output
아웅 : aung
아유타야 : ayutthaya
아이 : eye
아이거 : eiger
아이기나 : aegina
아이기스토스 : aegisthos
아이나 : inah
아이네이아스 : aeneias
아이다 : aida
아이들링 : idling
아이딜 : idyll
아이러니 : irony
아이리스 : iris
아이링 : eyring
아이마크 : aimak
아이반호 : ivanhoe
아이보리 : ivory
아이볼트 : eyebolt
아이셰이드 : eyeshade
아이소메트릭스 : isometrics
아이소스핀 : isospin
아이소타이프 : isotype
아이소토프 : isotope
아이솔레이터 : isolator
아이스 : ice
아이스박스 : icebox
아이스키네스 : aeschines
아이슬란드 : iceland
아이아스 : aeas
아이아코스 : aiacos
아이오와 : iowa
아이올로스 : aiolos
아이젠하워 : eisenhower
아이코노그래피 : iconography
아이코노미터 : iconometer
아이코노스코프 : iconoscope
아이크 : ike
아이템 : item
아이피오르니스 : aepyornis
아이히만 : eichmann
아인슈타인 : einstein
아인시타이늄 : einsteinium
아일 : aisle
아일랜드 : ireland
아일릿 : eyelet
아자르 : hazard
아잔타 : ajanta
아제 : atget
아제르바이잔 : azerbaidzhan
아조벤젠 : azobenzene
아조토미터 : azotometer
아조토박터 : azotobacter
아졸 : azol
아지리딘 : aziridine
아지테이터 : agitator
아진 : azine
아치 : arch
아카데미 : academy
아카데미즘 : academism
아카드 : akkad
아카루스 : acarus
아카바 : aqaba
아카이아 : achaea
아카풀코 : acapulco
아칸서스 : acanthus
아케르나르 : achernar
아케이드 : arcade
아코디언 : accordion
아콜라 : akola
아콰마린 : aquamarine
아쿠레이리 : akureyri
아크 : arc
아크라 : accra
아크라이트 : arkwright
아크로메갈리 : acromegaly
아크로신 : acrosin
아크로폴리스 : acropolis
아크리놀 : acrinol
아크리딘 : acridine
아크릴라이트 : acrylite
아크릴아미드 : acrylamide
아크몰린스크 : akmolinsk
아크바르 : akbar
아키메네스 : achimenes
아키텍처 : architecture
아킬레스 : achilles
아타나시우스 : athanasius
아타왈파 : atahualpa
아탈란타 : atalanta
아테나 : athena
아테네 : athenae
아테토시스 : athetosis
아토타이프 : artotype
아톤 : aton
아톰 : atom
아트레우스 : atreus
아트로핀 : atropine
아트리움 : atrium
아틀란티스 : atlantis
아티초크 : artichoke
아티카 : attica
아파르트헤이드 : apartheid
아파르트헤이트 : apartheit
아파타이트 : apatite
아펜젤러 : appenzeller
아펠도른 : apeldoorn
아펠란드라 : aphelandra
아포리즘 : aphorism
아포모르핀 : apomorphine
아포스트로피 : apostrophe
아폴로 : apollo
아폴로니오스 : apollonios
아폴로니우스 : apollonius
아폴론 : apollon
아폴리네르 : apollinaire
아풀레이우스 : apuleius
아프간 : afghan
아프로디테 : aphrodite
아프리카너 : afrikaner
아프리칸더 : afrikander
아프리칸트로푸스 : africanthropus
아피아 : apia
아피아 : appia
아헨 : aachen
아홀로틀 : axolotl
아후라 : ahura
아흐마토바 : akhmatova
악세로프톨 : axerophtol
악센트 : accent
악타이온 : actaeon
악티노마이신 : actinomycin
악티노우라늄 : actinouranium
악티노이드 : actinoid
악티늄 : actinium
악티니드 : actinide
안 : hahn
안나 : anna
안나바 : annaba
안나푸르나 : annapurna
안달루시아 : andalucia
안달루시안 : andalusian
안데르센 : andersen
안도라 : andorra
안드레예프 : andreev
안드로겐 : androgen
안드로메다 : andromeda
안드로이드 : android
안드로포프 : andropov
안디잔 : andizhan
안사 : ansa
안셀무스 : anselmus
안제예프스키 : andrzejewski
안젤리카 : angelica
안첸그루버 : anzengruber
안코나 : ancona
안타나나리보 : antananarivo
안타키아 : antakya
안테나 : antenna
안텔라미 : antelami
안토니누스 : antoninus
안토니우스 : antonius
안토시안 : anthocyan
안투 : antu
안트라센 : anthracene
안트라퀴논 : anthraquinone
안티노미 : antinomy
안티마그네틱 : antimagnetic
안티베리베린 : antiberiberin
안티센터 : anticenter
안티스테네스 : antisthenes
안티오코스 : antiochos
안티오키아 : antiochia
안티옥신 : antiauxin
안티코돈 : anticodon
안티크리스트 : antichrist
안티톡신 : antitoxin
안티피린 : antipyrine
알고리듬 : algorithm
알고리즘 : algorism
알골 : algol
알단 : aldan
알더 : alder
알데바란 : aldebaran
알도스테론 : aldosterone
알도오스 : aldose
알돌 : aldol
알라닌 : alanine
알라리크 : alaric
알란 : alan
알랭 : alain
알런덤 : alundum
알레익산드레 : aleixandre
알렉산드라이트 : alexandrite
알렉산드르 : aleksandr
알렉세예프 : alekseev
알렉세이 : aleksei
알렉신 : alexin
알렌카르 : alencar
알로마이세스 : allomyces
알로사우루스 : allosaurus
알로카시아 : alocasia
알로하 : aloha
알루마이트 : alumite
알루미나 : alumina
알루미논 : aluminon
알루미늄 : aluminium
알리가르 : aligarh
알리나민 : alinamin
알리바이 : alibi
알리자린 : alizarine
알리칸테 : alicante
알리티아민 : allithiamine
알마게스트 : almagest
알마티 : almaty
알메이다 : almeida
알바니 : albani
알바니아 : albania
알바레즈 : alvarez
알베르스 : albers
알베르투스 : albertus
알베르티 : alberti
알부미노이드 : albuminoid
알부민 : albumin
알부케르케 : albuquerque
알비노니 : albinoni
알비레오 : albireo
알자스 : alsace
알카이오스 : alkaeos
알칸 : alkane
알칼로시스 : alkalosis
알칼리 : alkali
알케스티스 : alcestis
알켄 : alkene
알코올 : alcohol
알크마르 : alkmaar
알크마이온 : alkmaion
알킨 : alkyne
알킬 : alkyl
알킬렌 : alkylene
알타이 : altai
알타이르 : altair
알텐베르크 : altenberg
알튀세 : althusser
알트도르퍼 : altdorfer
알파벳 : alphabet
알파카 : alpaca
알팍스 : alpax
알프스 : alps
알피에리 : alfieri
알하젠 : alhazen
암 : arm
암만 : amman
암모나이트 : ammonite
암모놀리시스 : ammonolysis
암모니아 : ammonia
암미터 : ammeter
암본 : ambon
암스테르담 : amsterdam
암스트롱 : armstrong
암페어 : ampere
암피실린 : ampicillin
암하라 : amhara
압살롬 : absalom
압하스 : abkhaz
앙가르스크 : angarsk
앙고라 : angora
앙골라 : angola
앙기나 : angina
앙상블 : ensenble
앙세르메 : ansermet
앙제 : angers
앙카라 : ankara
앙케이트 : enzuete
앙코르 : angkor
앙투아네트 : antoinette
앙투안 : antoine
애그리비즈니스 : agribusiness
애너벨 : annabel
애너스티그매틱 : anastigmatic
애너콘다 : anaconda
애널리스트 : analyst
애노드 : anode
애니매토그래프 : animatograph
애니머티즘 : animatism
애니멀리즘 : animalism
애니메이션 : animation
애니모미터 : anemometer
애니미즘 : animism
애덤스 : adams
애덤자이트 : adamsite
애들레이드 : adelaide
애디슨 : addison
애로헤드 : arrowhead
애먼타딘 : amantadine
애미시스트 : amethyst
애버레이션 : aberration
애버크롬비 : abercromby
애슈턴 : ashton
애스퀴스 : asquith
애스터 : aster
애스턴 : aston
애스테어 : astair
애스틀리 : astley
애치슨 : acheson
애쿼틴트 : aquatint
애퀄렁 : aqualung
애트우드 : attwood
애틀랜타 : atlanta
애틀러스 : atlas
애티튜드 : attitude
애틱 : attic
애퍼크로매틱 : apochromatic
애프터 : after
애프터버너 : afterburner
애프터케어 : aftercare
애플라이트 : aplite
애플리케이션 : application
애플릿 : applet
애피타이저 : appetizer
액드 : acth
액세서리 : accessory
액셀러레이터 : accelerator
액션 : action
액토미오신 : actomyosin
액티노마이세스 : actinomyces
액티노미터 : actinometer
액티브 : active
액틴 : actin
액팅 : acting
앤 : anne
앤드 : and
앤드롤로지 : andrology
앤섬 : anthem
앤솔러지 : anthology
앤슈리엄 : anthurium
앤지오텐시노겐 : angiotensinogen
앤지오텐신 : angiotensin
앤터니 : anthony
앤티노크 : antinock
앤티미사일 : antimissile
앤티크 : antique
앤티프로톤 : antiproton
앨라모고도 : alamogordo
앨라배민 : alabamine
앨러페인 : allophane
앨리 : alley
앨리게이터 : alligator
앨버커키 : albuquerque
앨버트로스 : albatross
앨범 : album
앨트루이즘 : altruism
앨프릭 : aelfric
앰풀 : ampoule
앰플리다인 : amplidyne
앰플리파이어 : amplifier
앰플스타일 : amplestyle
앱스트랙트 : abstract
앵그르 : ingres
앵글 : angle
앵커 : anchor
앵커 : anker
앵커리지 : anchorage
앵클릿 : anklet
야노스 : llanos
야누스 : janus
야드 : yard
야렌 : yaren
야로슬라블 : yaroslavl
야운데 : yaound
야코비 : jacobi
야코비니아 : jacobinia
야콥슨 : jakobson
야쿠츠크 : yakutsk
야쿠트 : yakut
야페토스 : japetos
야훼 : yahweh
얀 : jahn
얀세니우스 : jansenius
얀센 : jansen
얄타 : yalta
양키 : yankee
어게인 : again
어닐링 : annealing
어덴덤 : addendum
어드레스 : address
어드미턴스 : admittance
어드밴티지 : advantage
어드벤처러스 : adventurers
어디 : ady
어모퍼스 : amorphous
어민 : ermine
어빙 : irving
어셈블러 : assembler
어셈블리 : assembly
어셈블리지 : assemblage
어웨이 : away
어저스트 : adjust
어제일리어 : azalea
어카운트 : account
어컴퍼니먼트 : accompaniment
어코드 : accord
어태치먼트 : attachment
어태칭 : attaching
어태커 : attacker
어틀랜티즈 : atlantes
어퍼컷 : uppercut
어프로치 : approach
어필 : appeal
억셉터 : acceptor
언더그라운드 : underground
언더라이터 : underwriter
언더스핀 : underspin
언더웨어 : underwear
언더컷 : undercut
언러키 : unlucky
언커트 : uncut
언코크 : uncok
언타이드 : untied
얼랭어 : erlanger
얼리 : early
얼스터 : ulster
엄파이어 : umpire
업 : up
업그레이드 : upgrade
업로드 : upload
에고이스트 : egoist
에고이즘 : egoism
에그몬트 : egmont
에그버트 : egbert
에글스턴 : eggleston
에너지 : energy
에너지즘 : energism
에네스코 : enesco
에니 : eni
에니악 : eniac
에다 : edda
에듀케이션 : education
에드먼턴 : edmonton
에드박 : edvac
에드워디언 : edwardian
에든버러 : edinburgh
에디슨 : edison
에디아카라 : ediacara
에디오나미드 : ethionamide
에디토리얼 : editorial
에딩턴 : eddington
에라르 : rard
에라스무스 : erasmus
에라토스테네스 : eratosthenes
에러 : error
에렉투스 : erectus
에렌부르크 : erenburg
에렙신 : erepsin
에로아 : eroa
에로이카 : eroica
에로티시즘 : eroticism
에르고미터 : ergometer
에르고스테롤 : ergosterol
에르고타민 : ergotamine
에르나니 : hernani
에르데니차오 : erdenichao
에르마크 : ermak
에르미트 : hermite
에르븀 : erbium
에르비외 : hervieu
에르주룸 : erzurum
에르츠베르거 : erzberger
에르푸르트 : erfurt
에른스트 : ernst
에를랑겐 : erlangen
에를리히 : ehrlich
에리다누스 : eridanus
에리두 : eridu
에리스 : eris
에리오크롬 : eriochrome
에리옵스 : eryops
에리카이트 : erikite
에리트레아 : eritrea
에리트로마이신 : erythromycin
에리트로포이에틴 : erythropoietin
에릭슨 : ericsson
에마뉘엘 : emmanuel
에머리 : emery
에머슨 : emerson
에멀션 : emulsion
에메 : aym
에메랄드 : emerald
에메틴 : emetine
에뮬레이션 : emulation
에미그런트 : emigrant
에미네스쿠 : eminescu
에반젤린 : evangelin
에발 : ewald
에버리스트 : everest
에번스 : evans
에번즈빌 : evansville
에베르트 : ebert
에보나이트 : ebonite
에볼류트 : evolute
에부라 : vora
에빙하우스 : ebbinghaus
에사키 : esaki
에세린 : eserine
에센 : essen
에센스 : essence
에셴바흐 : eschenbach
에스노센트리즘 : ethnocentrism
에스로 : esro
에스마르히 : esmarch
에스캅 : escap
에스커 : esker
에스컬레이터 : escalator
에스코트 : escort
에스코피에 : escoffier
에스콰이어 : esquire
에스키모 : eskimo
에스킬스투나 : eskilstuna
에스탄시아 : estancia
에스테이트 : estate
에스토니아 : estonia
에스토펠 : estoppel
에스트라다 : estrada
에스트라디올 : estradiol
에스트레마두라 : extremadura
에스트론 : estron
에스트론 : estrone
에스트리올 : estriol
에스티오메네 : esthiomene
에스파한 : esfahan
에스페란토 : esperanto
에스피 : espy
에스헤르 : escher
에아 : ea
에어 : eyre
에어러그램 : aerogram
에어로빅 : aerobic
에어로졸 : aerosol
에어리 : airy
에어리어 : area
에어브러시 : airbrush
에어셔 : ayrshire
에오스 : eos
에오안트로푸스 : eoanthropus
에오카 : eoka
에오히푸스 : eohippus
에우독소스 : eudoxos
에우리피데스 : euripides
에우세비오스 : eusebios
에이드 : ade
에이드리언 : adrian
에이레 : eire
에이버리 : avery
에이샛 : asat
에이전시 : agency
에이젠슈테인 : eisenstein
에이즈 : aids
에이커 : acre
에이크 : eyck
에이크만 : eijkman
에이킨 : aitken
에이킨스 : eakins
에이트 : eight
에이펙 : apec
에이프런 : apron
에이헨바움 : eikhenbaum
에인절 : angell
에인절피시 : angelfish
에인트호벤 : eindhoven
에일라트 : eilat
에일레이투이아 : eileithuia
에일리어스 : alias
에지워스 : edgeworth
에체가라이 : echegaray
에칭 : etching
에커만 : eckermann
에케르트 : eckert
에코 : echo
에콰도르 : ecuador
에퀴티 : equity
에큐 : ecu
에큐메니즘 : ecumenism
에크 : eck
에크하르트 : eckhart
에클로자이트 : eclogite
에키노마이신 : echinomycin
에키호스 : exihos
에타나 : etana
에타크리딘 : ethacridine
에탄알 : ethanal
에탄올 : ethanol
에탄올아민 : ethanolamine
에테르 : ether
에테지안 : etesian
에텐자미드 : ethenzamid
에트랑제 : etranger
에트루리아 : etruria
에티엔 : etienne
에티켓 : etiquette
에틴 : ethyne
에틸 : ethyl
에틸렌디아민 : ethylendiamine
에틸아민 : ethylamine
에틸아세틸렌 : ethylacetylene
에파미논다스 : epaminondas
에페드린 : ephedrine
에페수스 : ephesus
에포로이 : ephoroi
에프타 : efta
에피네프린 : epinephrine
에피소드 : episode
에피솜 : episome
에피스틸륨 : epistylium
에피칸투스 : epicantus
에피쿠로스 : epicouros
에피택시 : epitaxy
에흐몬트 : egmont
엑고닌 : ecgonine
엑디손 : ecdysone
엑서터 : exeter
엑센 : exsaine
엑스커베이터 : excavator
엑스트랙트 : extract
엑스트러 : extra
엑슬란 : exlan
엑토고니 : ectogony
엑토플라즘 : ectoplasm
엔니우스 : ennius
엔더비 : enderby
엔더스 : enders
엔도르핀 : endorphine
엔드 : end
엔드리스 : endless
엔리케 : henrique
엔비크 : hennebique
엔사이클로피디어 : encyclepaedia
엔실리지 : ensilage
엔지니어 : engineer
엔지니어링 : engineering
엔타시스 : entasis
엔탈피 : enthalpy
엔테로바이러스 : enterovirus
엔테베 : entebbe
엔트런스 : entrance
엔트로피 : entropy
엔하모닉 : enharmonic
엘 : ell
엘가 : elgar
엘도 : eldo
엘라가발루스 : elagabalus
엘라스토머 : elastomer
엘람 : elam
엘레본 : elevon
엘레우시스 : eleusis
엘렉트라 : electra
엘뤼아르 : luard
엘리베이터 : elevator
엘리스 : ellis
엘리스타 : elista
엘리슨 : ellison
엘리야 : eliyah
엘리엇 : eliot
엘리트 : elite
엘린바 : elinvar
엘린트 : elint
엘링턴 : ellington
엘브거스트 : elvegust
엘스터 : elster
엘스하이머 : elsheimer
엘크 : elk
엠덴 : emden
엠보싱 : embossing
엠페도클레스 : empedocles
엠펙 : mpeg
엠프슨 : empson
엡스타인 : epstein
엡스탱 : epstein
엡시딕 : ebcdic
엥겔 : engel
엥겔스 : engels
엥글러 : engler
여피 : yuppie
영 : young
영거 : younger
예레반 : erevan
예루살렘 : jerusalem
예르생 : yersin
예링 : jhering
예멘 : yemen
예세닌 : esenin
예스페르센 : jespersen
예이츠 : yeats
예카테리나 : ekaterina
옌젠 : jensen
옐로 : yellow
옐로케이크 : yellowcake
옐리네크 : jellinek
오가료프 : ogaryov
오건디 : organdy
오고타이 : ogotai
오그던 : ogden
오그보모쇼 : ogbomosho
오그푸 : ogpu
오나거 : onager
오너 : honor
오너먼트 : ornament
오네게르 : honegger
오네스 : onnes
오니차 : onitsha
오닉스 : onyx
오데브레히트 : odebrecht
오데사 : odessa
오데츠 : odets
오도미터 : odometer
오도아케르 : odoacer
오도예프스키 : odoevskii
오드 : ode
오든 : auden
오디세우스 : odysseus
오디오 : audio
오디오미터 : audiometer
오딘 : odin
오라데아 : oradea
오라토리오 : oratorio
오랑 : oran
오레스테스 : orestes
오레스테이아 : oresteia
오레오피테쿠스 : oreopithecus
오렌지 : orange
오렘 : oresme
오로스코 : orozco
오로촌 : orochon
오룔 : oryol
오르가눔 : organum
오르간 : organ
오르니틴 : ornithine
오르마즈드 : ormazd
오르먼디 : ormandy
오르비톨리나 : orbitolina
오르시놀 : orcinol
오르카냐 : orcagna
오르코메노스 : orchomenos
오르텔리우스 : ortelius
오르토 : ortho
오르토팬 : orthopan
오르트 : oort
오르페우스 : orpheus
오르프 : orff
오리게네스 : origenes
오리겐 : origen
오리엔탈리즘 : orientalism
오리엔티어링 : orienteering
오리온 : orion
오리올 : auriol
오리크 : auric
오리피스 : orifice
오릭스 : oryx
오만 : oman
오메가 : omega
오메프라졸 : omeprazole
오버 : over
오버드라이브 : overdrive
오버래핑 : overlapping
오버러닝 : overrunning
오버런 : overrun
오버블라우스 : overblouse
오버슈즈 : overshoes
오버스로 : overthrow
오버스텝 : overstep
오버액션 : overaction
오버액트 : overact
오버작센 : obersachsen
오버추어 : overture
오버코트 : overcoat
오버타임 : overtime
오버톤 : overtone
오버패스 : overpass
오버핸드 : overhand
오버행 : overhang
오버헤드 : overhead
오버히트 : overheat
오베론 : oberon
오베르 : auber
오베치킨 : ovechkin
오벨리스크 : obelisk
오벨리아 : obelia
오브 : of
오브레히트 : obrecht
오브시치나 : obshchina
오브젝트 : object
오븐 : oven
오블로모프 : oblomov
오비에도 : oviedo
오비탈 : orbital
오비터 : orbiter
오세아니아 : oceania
오셀로 : othello
오소르노 : osorno
오슈 : hoche
오스람 : osram
오스만리 : osmanli
오스미리듐 : osmiridium
오스카 : oscar
오스타데 : ostade
오스트라바 : ostrava
오스트라시즘 : ostracism
오스트랄라시아 : australasia
오스트레일리아 : australia
오스트레일리아 : australian
오스트로프스키 : ostrovskii
오스트발트 : ostwald
오스티아 : ostia
오스틴 : austen
오슬러 : osler
오슬로 : oslo
오시리스 : osiris
오시에츠키 : ossietzky
오시예크 : osijek
오시콘 : orthicon
오실로스코프 : oscilloscope
오실롯 : ocelot
오아시스 : oasis
오악사카 : oaxaca
오어 : oar
오어 : or
오어니즘 : owenism
오언 : owen
오언스 : owens
오웰 : orwell
오이디푸스 : oedipus
오이라트 : oirat
오이켄 : eucken
오일 : oil
오일러 : euler
오일스킨 : oilskin
오일클로스 : oilcloth
오장팡 : ozenfant
오존 : ozone
오즈번 : osborne
오카리나 : ocarina
오카피 : okapi
오커 : ocher
오컬티즘 : occultism
오컴 : ockham
오케스트라 : orchestra
오케아노스 : okeanos
오켄 : oken
오크 : oak
오클랜드 : auckland
오클랜드 : oakland
오타리아 : otaria
오타코이드 : autacoid
오터 : otter
오터나이트 : autunite
오토 : otto
오토라디오그래프 : autoradiograph
오토마타 : automata
오토만 : ottoman
오토매틱 : automatic
오토맷 : automat
오토솜 : autosome
오토자이로 : autogyro
오토클레이브 : autoclave
오트레드 : oughtred
오트렐라이트 : ottrelite
오트밀 : oatmeal
오티스 : otis
오파놀 : oppanol
오파린 : oparin
오팔리나 : opalina
오패시파이어 : opacifier
오퍼 : offer
오퍼레이션 : operation
오퍼레이터 : operator
오페라 : opera
오페레타 : operetta
오페론 : operon
오페이크 : opaque
오펙 : opec
오펜바흐 : offenbach
오펜하이머 : oppenheimer
오폴레 : opole
오프 : off
오프사이드 : offside
오프셋 : offset
오프쇼어 : offshore
오픈 : open
오피올라이트 : ophiolite
오피츠 : opitz
옥살리스 : oxalis
옥소늄 : oxonium
옥소캠퍼 : oxocamphor
옥시나프탈렌 : oxynaphthalene
옥시던트 : oxidant
옥시덴트 : occident
옥시미터 : oximeter
옥시테트라사이클린 : oxytetracycline
옥시토신 : oxytocin
옥신 : auxin
옥신 : oxine
옥심 : oxime
옥타브 : octave
옥타비아 : octavia
옥타비아누스 : octavianus
옥탄트 : octant
옥텟 : octet
온 : on
온사게르 : onsager
온사이드 : onside
올 : all
올그런 : algren
올덴부르크 : oldenburg
올딩턴 : aldington
올라르 : aulard
올레샤 : olesha
올레오댐퍼 : oleodamper
올레오레진 : oleoresin
올레오미터 : oleometer
올레핀 : olefin
올로모우츠 : olomouc
올름 : olm
올리버 : oliver
올리베이라 : oliveira
올리브 : olive
올린 : ohlin
올림피아 : olympia
올림피아드 : olympiad
올버니 : albany
올베르스 : olbers
올보르 : lborg
올컷 : alcott
올콕 : alcock
올포트 : allport
옴니레인지 : omnirange
옴니버스 : omnibus
옴두르만 : omdurman
옴빌린 : ombilin
옴스크 : omsk
옵서버 : observer
옵션 : option
옵소닌 : opsonin
옵스트펠데르 : obstfelder
옵타콘 : optacon
옵터폰 : optophone
옵티멈 : optimum
옵티미터 : optimeter
옵티컬 : optical
옵틱 : optic
와가두구 : ouagadougou
와그너 : wagner
와디 : wadi
와스프 : wasp
와이더 : wider
와이드 : wide
와이어 : wire
와이어리스 : wireless
와이엇 : wyatt
와이퍼 : wiper
와이프 : wipe
와인글라스 : wineglass
와일더 : wilder
와일드 : wilde
와일드캣 : wildcat
와트 : wat
와트 : watt
와트미터 : wattmeter
와플 : waffle
왁스 : wax
왁스먼 : waksman
완타르 : huantar
왈라비 : wallaby
왈라키아 : walachia
왈츠 : waltz
왕거누이 : wanganui
왜건 : wagon
외벨란 : verland
요구르트 : yogurt
요그야카르타 : yogyakarta
요들 : yodel
요르단 : jordan
요르단스 : jordaens
요시야 : josiah
요아킴 : joachim
요앙 : joan
요야김 : joiakim
요요 : yoyo
요크 : yoke
요크셔 : yorkshire
요크타운 : yorktown
요페 : ioffe
요하네스버그 : johannesburg
요한네스 : johannes
요힘빈 : yohimbin
욘손 : jonson
욘존 : johnson
우가리트 : ugarit
우간다 : uganda
우나무노 : unamuno
우도칸 : udokan
우동 : houdon
우드 : wood
우드워드 : woodward
우드워스 : woodworth
우드하우스 : wodehouse
우라노스 : ouranos
우라늄 : uranium
우라니나이트 : uraninite
우라닐 : uranyl
우라실 : uracil
우랄 : ural
우레아제 : urease
우레아포름 : ureaform
우레탄 : urethane
우로크롬 : urochrome
우로트로핀 : urotropine
우루과이 : uruguay
우루크 : uruk
우르 : ur
우르겐치 : urgench
우마이야 : umayya
우발레 : uvale
우수리스크 : ussuriisk
우스터 : worcester
우스티드 : worsted
우엘바 : huelva
우자인 : ujjain
우즈베크 : uzbek
우지다 : oujda
우첼로 : uccello
우쿨렐레 : ukulele
우크라인카 : ukrainka
우파 : ufa
우파스 : upas
운드로 : undro
운라 : unrra
운르와 : unrwa
운크라 : unkra
운크타드 : unctad
울 : wool
울러스턴 : wollaston
울르 : ullr
울리 : woolley
울브리히트 : ulbricht
울스턴크래프트 : wollstonecraft
울트라 : ultra
울프 : wolfe
울프 : woolf
울피아누스 : ulpianus
웁살라 : uppsala
웅가레티 : ungaretti
워 : waugh
워드 : ward
워드 : word
워커빌리티 : workability
워크 : walk
워크 : work
워크스테이션 : workstaion
워크아웃 : walkout
워킹 : walking
워터벅 : waterbuck
워터베리 : waterbury
워터퍼드 : waterford
워프 : whorf
워홀 : warhol
원 : one
월드 : world
월리스 : wallace
월리스 : wallis
월솔 : walsall
월싱엄 : walsingham
월턴 : walton
웜 : worm
웜뱃 : wombat
웨들 : weddell
웨섹스 : wessex
웨스터마크 : westermarck
웨스턴 : western
웨스트 : west
웨스트민스터 : westminster
웨스트팔리아 : westphalia
웨슬리 : wesley
웨어링 : wearing
웨이 : way
웨이브 : wave
웨이스트 : waist
웨이스트 : waste
웨이터 : waiter
웨이트 : weight
웨이트리스 : waitress
웨이퍼 : wafer
웨인 : wayne
웨일리 : waley
웨지 : wedge
웨지우드 : wedgwood
웨트 : wet
웰스 : wells
웰위치아 : welwitschia
웰즐리 : wellsley
웹 : web
위고 : hugo
위구르 : uighur
위닝 : winning
위더라이트 : witherite
위도 : widow
위빙 : weaving
위스망스 : huysmans
위스콘신 : wisconsin
위스키 : whiskey
위슬러 : wissler
위지위그 : wysiwyg
위치토 : wichita
위크 : weak
위클리프 : wycliffe
위킷키퍼 : wicketkeeper
위트레흐트 : utrecht
위트릴로 : utrillo
윈도 : windows
윈드브레이커 : windbreaker
윈드서핑 : windsurfing
윈저 : windsor
윈즈 : winds
윈체스터 : winchester
윈타테륨 : uintatherium
윌레마이트 : willemite
윌리엄 : william
윌밍턴 : wilmington
윌버포스 : wilberforce
윌크스 : wilkes
윌킨스 : wilkins
윌킨슨 : wilkinson
윔블던 : wimbledon
윙 : wing
윙크 : wink
유겐트 : jugend
유고 : yugo
유고슬라비아 : yugoslavia
유글레나 : euglena
유네스코 : unesco
유노 : juno
유니버설 : universal
유니버시아드 : universiade
유니세프 : unicef
유니슨 : unison
유니언 : union
유니테리언 : unitarians
유닛 : unit
유디오미터 : eudiometer
유라시아 : eurasia
유라톰 : euratom
유라프리카 : eurafrica
유러너스 : uranus
유러코뮤니즘 : eurocommunism
유럽 : europe
유레일패스 : eurailpass
유로파 : europa
유로포르트 : europort
유로퓸 : europium
유르트 : yurt
유리 : urey
유머레스크 : humoresque
유세이드 : usaid
유스타키오 : eustachio
유잉 : ewing
유저 : user
유전스 : usance
유진 : eugene
유카 : yucca
유카와 : yukawa
유클리드 : euclid
유토피아 : utopia
유티카 : utica
유포니 : euphony
유포니움 : euphonium
유포리온 : euphorion
유피미즘 : euphemism
유피테르 : jupiter
유헤메로스 : euhemeros
율리아누스 : julianus
융 : jung
융커스 : junkers
음바바네 : mbabane
음반다카 : mbandaka
이구아나 : iguana
이그나이트론 : ignitron
이그나티예프 : ignatiev
이그나티오스 : ignatios
이글 : eagle
이글루 : igloo
이너 : inner
이노시톨 : inositol
이노케라무스 : inoceramus
이눌린 : inulin
이니시에이션 : initiation
이닝 : inning
이달고 : hidalgo
이도메네우스 : idomeneus
이든 : eden
이라클리온 : iraklion
이란 : iran
이레이디에이션 : irradiation
이르쿠츠크 : irkutsk
이리 : erie
이리 : iri
이리스 : iris
이마 : yima
이머만 : immermann
이무란 : imuran
이미노 : imino
이미다졸 : imidazole
이미르 : ymir
이미저리 : imagery
이미지 : image
이미터 : emitter
이미테이션 : imitation
이미프라민 : imipramine
이바게 : ibagu
이바노보 : ivanovo
이바노프 : ivanov
이바르부루 : ibarbourou
이바슈키에비치 : iwaszkiewicz
이베리아 : iberia
이브닝 : evening
이븐 : even
이사 : esa
이사틴 : isatin
이삭 : isaac
이삭스 : isaacs
이소 : iso
이소니아지드 : isoniazid
이소니트릴 : isonitrile
이소모피즘 : isomorphism
이소부탄 : isobutane
이소부틸렌 : isobutylene
이소옥탄 : isooctane
이소퀴놀린 : isoquinoline
이소크라테스 : isocrates
이소프로테레놀 : isoproterenol
이소프로판올 : isopropanol
이소프로필 : isopropyl
이슈 : issue
이슈타르 : ishtar
이스라엘 : israel
이스케이프먼트 : escapement
이스켄데룬 : iskenderun
이스탄불 : istanbul
이스트 : yeast
이스트라티 : istrati
이스트먼 : eastman
이슬라마바드 : islamabad
이슬람 : islam
이아손 : iason
이어마크 : earmark
이어폰 : earphone
이오 : io
이오논 : ionone
이오늄 : ionium
이오니아 : ionia
이온 : ion
이온토포레시스 : iontophoresis
이올리스 : eolith
이제프스크 : izhevsk
이젝션 : ejection
이즈 : eads
이즘 : ism
이집트 : egypt
이카로스 : icaros
이퀄 : equal
이퀄라이저 : equalizer
이크나톤 : ikhenaton
이탈리아 : italia
이탤릭 : italic
이테르븀 : ytterbium
이트륨 : yttrium
이트리아 : yttria
이펙트 : effect
이포 : ipoh
이플란트 : iffland
이피게네이아 : iphigeneia
이피롬 : eprom
익스팬더 : expander
익시아 : ixia
익티노스 : iktinos
익티오사우루스 : ichthyosaurus
인 : in
인단 : indan
인더스트리얼 : industrial
인덱스 : index
인도네시아 : indonesia
인도르 : indore
인돌 : indole
인듐 : indium
인드라 : indra
인디 : indie
인디고 : indigo
인디아 : india
인디언 : indian
인디케이터 : indicator
인레이 : inlay
인버네스 : inverness
인버카길 : invercargill
인버터 : inverter
인베르타아제 : invertase
인벤션 : invention
인벤토리 : inventory
인사이드 : inside
인슈트 : inshoot
인슐린 : insulin
인스 : ince
인스부르크 : innsbruck
인스텝 : instep
인스트루멘털리즘 : instrumentalism
인스티튜션 : institution
인젝션 : injection
인치 : inch
인카운터 : encounter
인컴 : income
인코넬 : inconel
인코더 : encoder
인큐내뷸러 : incunabula
인큐베이터 : incubator
인클라인 : incline
인터 : inter
인터내셔널 : international
인터넷 : internet
인터럽트 : interrupt
인터로크 : interlock
인터로킹 : interlocking
인터류킨 : interleukin
인터벌 : interval
인터뷰 : interview
인터체인지 : interchange
인터컷 : intercut
인터타이프 : intertype
인터페이스 : interface
인터폰 : interphone
인터폴 : interpol
인터피어 : interfere
인턴 : intern
인테리어 : interior
인텔리전트 : intelligent
인텔샛 : intelsat
인트론 : intron
인티그레이티드 : integrated
인파이터 : infighter
인포머셜 : informercial
인포멀 : informal
인플랜트 : inplant
인플렉션 : inflection
인플루엔자 : influenza
일 : il
일렉트렛 : electret
일렉트로그래프 : electrograph
일렉트로닉 : electronic
일렉트로세라믹스 : electroceramics
일렉트로제트 : electrojet
일렉트로커뮤니케이션 : electrocommunication
일로린 : ilorin
일로스 : ilos
일로일로 : iloilo
일리미네이터 : eliminator
일리아드 : iliad
일리아스 : ilias
임코 : imco
임팔 : imphal
임팔라 : impala
임팩트 : impact
임펄스 : impulse
임펠러 : impeller
임피던스 : impedance
임호프 : imhoff
입세니즘 : ibsenism
입스위치 : ipswich
잉 : inge
잉겐호우스 : ingenhousz
잉곳 : ingot
잉글랜드 : england
잉글리시 : english
잉크 : ink
잉크스탠드 : inkstand
잉크젯 : inkjet
자그레브 : zagreb
자네 : janet
자다르 : zadar
자라투스트라 : zarathustra
자르 : saar
자리 : jarry
자멘호프 : zamenhof
자바 : java
자발푸르 : jabalpur
자술리치 : zasulich
자야푸라 : djajapura
자우어 : sauer
자이로스코프 : gyroscope
자이로스태빌라이저 : gyrostabilizer
자이로컴퍼스 : gyrocompass
자이르 : zaire
자이미니 : jaimini
자이언트 : giant
자이펠 : seipel
자이푸르 : jaipur
자일스 : giles
자카르타 : jakarta
자카프카지예 : zakavkazye
자칼 : jackal
자코브 : jacob
자코사 : giacosa
자키 : jockey
자파드니키 : zapadnikii
자포로제 : zaporozhe
자프나 : jaffna
작스 : sachs
잔지바르 : zanzibar
잔캥 : jannequin
잠비아 : zambia
잠셰드푸르 : jamshedpur
장 : jean
장르 : genre
재규어 : jaguar
재스민 : jasmine
재즈 : jazz
재킷 : jacket
잭나이프 : jackknife
잭슨 : jackson
잭슨빌 : jacksonville
잼 : jam
잼버리 : jamboree
잽 : jab
저글 : juggle
저널 : journal
저널리스트 : journalist
저드 : judd
저먼 : german
저미스턴 : germiston
저지 : judge
점보 : jumbo
점보트론 : jumbotron
점핑 : jumping
정글 : jungle
정크 : junk
제너 : zener
제너럴 : general
제너럴십 : generalship
제네바 : geneva
제네펠더 : senefelder
제노 : zeno
제노사이드 : genocide
제노아 : genoa
제노타임 : xenotime
제다 : jedda
제럴드 : jerrold
제로그래피 : xerography
제로니모 : geronimo
제록스 : xerox
제롬스키 : eromski
제르니케 : zernike
제르미날 : germinal
제리아 : jeria
제리애트릭스 : geriatrics
제만 : zeeman
제몰라이트 : gemolite
제번스 : jevons
제베크 : seebeck
제셀턴 : jesselton
제수이트 : jesuit
제스처 : gesture
제우스 : zeus
제욱시스 : zeuxis
제인 : jane
제임스타운 : jamestown
제타 : zeta
제트 : jet
제퍼슨 : jefferson
제프리스 : jeffreys
제피로스 : zephyros
젤라티나아제 : gelatinase
젤라티노브로마이드 : gelatinobromide
젤라틴 : gelatin
젬 : gem
젬퍼 : semper
조 : jaw
조닝 : zoning
조델 : jodelle
조드푸르 : jodhpur
조르다노 : giordano
조르당 : jordan
조베르티 : gioberti
조스캥 : josquin
조에아 : zoea
조이사이트 : zoisite
조이스 : joyce
조이제 : seuse
조인트 : joint
조젯 : georgette
조지타운 : georgetown
조커 : joker
조크 : joke
조키 : jocky
조프르 : joffre
조플린 : joplin
존 : john
존드 : zond
존스 : jones
존스타운 : johnstown
존타 : zonta
졸라 : zola
졸리베 : jolivet
졸링겐 : solingen
좀바 : zomba
좀바르트 : sombart
주노 : juno
주니어 : junior
주다노프 : zhdanov
주롱 : jurong
주밍 : zooming
주베 : jouvet
주스 : juice
주스티 : giusti
주앵빌 : joinville
주치 : juchi
주코프 : zhukov
주코프스키 : zhukovskii
주트 : jute
주트너 : suttner
주페 : supp
준케이루 : junqueiro
줄 : joule
줄루란드 : zululand
줌 : zoom
중가르 : jungar
중가리아 : zungaria
쥐스 : suess
쥐시외 : jussieu
쥘 : jules
즐라토우스트 : zlatoust
지겐 : siegen
지구라트 : ziggurat
지그몬디 : zsigmondy
지그소 : jigsaw
지그자그 : zigzag
지기스문트 : sigismund
지노비예프 : zinovyev
지다 : jidda
지드 : gide
지라르동 : girardon
지로 : giro
지롱댕 : girondins
지르갈란토 : zirgalanto
지르코늄 : zirconium
지멘스 : siemens
지멜 : simmel
지베렐린 : gibberellin
지볼트 : siebold
지부티 : djibouti
지브 : jib
지브롤터 : gibraltar
지엔피 : gnp
지오노 : giono
지오이드 : geoid
지오크 : giauque
지켈 : sickel
지크프리트 : siegfried
지킹겐 : sickingen
지프 : jeep
진 : gin
진 : jean
진나 : jinnah
진스 : jeans
진저 : ginger
질레지우스 : silesius
질리 : gigli
질송 : gilson
짐바브웨 : zimbabwe
짐카나 : gymkhana
집시 : gypsy
징글 : jingle
징케나이트 : zinkenite
징크스 : jinx
차다예프 : chaadaev
차드 : chad
차라 : tzara
차리즘 : tsarism
차리친 : tsaritsyn
차바사이트 : chabasite
차우더 : chowder
차이나 : china
차이나타운 : chinatown
차이코프스키 : chaikovskii
차일드 : childe
차임 : chime
차징 : charging
차콜 : charcoal
차터 : charter
차트 : chart
차티즘 : chartism
차하르 : chakhar
찬드 : chand
찬드라굽타 : chandragupta
찬스 : chance
찬트 : chant
찰스턴 : charleston
채널 : channel
채드윅 : chadwick
채리엇 : chariot
채터턴 : chatterton
채팅 : chatting
채프 : chaff
채플 : chapel
채플린 : chaplin
챈들러 : chandler
챌린지 : challenge
챔퍼링 : chamfering
챔프 : champ
처치 : church
처칠 : churchill
처트 : chert
체라푼지 : cherrapunji
체렌코프 : cherenkov
체렘호보 : cheremkhovo
체르노빌 : chernobyl
체르노프 : chernov
체르노프치 : chernovtsy
체르니고프 : chernigov
체르니셰프스키 : chernyshevsky
체르마크 : tschermak
체리모야 : cherimoya
체복사리 : cheboksary
체비쇼프 : chebyshov
체사로티 : cesarotti
체살피노 : cesalpino
체스터 : chester
체스터턴 : chesterton
체스터필드 : chesterfield
체어 : chair
체어마트 : zermatt
체이스 : chase
체인지 : change
체인지오버 : changeover
체임버 : chamber
체임벌린 : chamberlain
체커 : checker
체케티 : cecchetti
체크 : check
체트킨 : zetkin
체펠린 : zeppelin
첸니니 : cennini
첼란 : celan
첼랴빈스크 : chelyabinsk
첼리노그라드 : tselinograd
첼리니 : cellini
첼리스트 : cellist
초커 : chocker
초콜라테로 : chocolatero
초콜릿 : chocolate
초크 : choke
초퍼 : chopper
촙 : chop
추크마이어 : zuckmayer
추크슈피체 : zugspitze
추키카마타 : chuquicamata
츠베타예바 : tsvetaeva
츠비카우 : zwickau
츠빙글리 : zwingli
치네치타 : cinecitta
치누크 : chinook
치레본 : tjirebon
치마부에 : cimabue
치머만 : zimmermann
치비타베키아 : civitavecchia
치올코프스키 : tsiolkovskii
치와와 : chihuahua
치즈 : cheese
치칼로프 : chkalov
치커리 : chicory
치크 : cheek
치클라요 : chiclayo
치타 : cheetah
치타 : chita
치텔 : zittel
치펀데일 : chippendale
치프 : chief
친첸도르프 : zinzendorf
친칠라 : chinchilla
친콤 : chincom
칠레 : chile
침보테 : chimbote
침켄트 : chimkent
칩 : chip
칩보드 : chipboard
칭골라 : chingola
카 : car
카 : carr
카 : ka
카나로 : canaro
카나리아 : canaria
카나린 : canarin
카나바닌 : canavanine
카나이트 : cahnite
카나카 : kanaka
카네기 : carnegie
카네기아이트 : carnegieite
카네이션 : carnation
카노타이트 : carnotite
카논 : canon
카니발 : carnival
카다베린 : cadaverine
카데트 : kadet
카드모스 : cadmos
카드뮴 : cadmium
카디건 : cardigan
카디오이드 : cardioid
카디프 : cardiff
카라 : carr
카라간다 : karaganda
카라바조 : caravaggio
카라샤르 : karashahr
카라지알레 : caragiale
카라치 : carracci
카라치 : karachi
카라카스 : caracas
카라칼 : caracal
카라칼라 : caracalla
카라코룸 : karakorum
카라한 : karakhan
카란사 : carranza
카러 : karrer
카레니나 : karenina
카렐 : karel
카로 : caro
카로사 : carossa
카로티나아제 : carotinase
카로틴 : carotin
카론 : charon
카롤리 : caroli
카루소 : caruso
카르나티크 : carnatic
카르납 : carnap
카르노 : carnot
카르니틴 : carnitine
카르두치 : carducci
카르디아졸 : cardiazol
카르멘 : carmen
카르바졸 : carbazole
카르바크롤 : carvacrol
카르발라 : karbala
카르보늄 : carbonium
카르보닐 : carbonyl
카르보란 : carborane
카르복시메틸 : carboxymethyl
카르복시펩티다아제 : carboxypeptidase
카르복시헤모글로빈 : carboxyhemoglobin
카르복실헤모글로빈 : carboxylhemoglobine
카르본 : carvone
카르비놀 : carbinol
카르사비나 : karsavina
카르스 : kars
카르스트 : karst
카르카손 : carcassonne
카르케미시 : carchemish
카르코 : carco
카르타고 : carthago
카르타민 : carthamin
카르타헤나 : cartagena
카르티에 : cartier
카르파초 : carpaccio
카르펜티에르 : carpentier
카르피니 : carpini
카를로스 : carlos
카를루크 : kharluk
카를스바트 : karlsbad
카리바 : kariba
카리부 : caribou
카리아티드 : caryatid
카리오솜 : karyosome
카마르고 : camargo
카마사이트 : kamacite
카마시아 : camassia
카메네프 : kamenev
카메라 : camera
카메라리우스 : camerarius
카메룬 : cameroon
카메하메하 : kamehameha
카멘나야 : kamennaya
카뮈 : camus
카민 : carmine
카바니 : cabanis
카발레리아 : cavalleria
카발레프스키 : kabalevskii
카발리에리 : cavalieri
카버 : carver
카베 : cabet
카베냐크 : cavaignac
카보나이트 : carbonite
카보나타이트 : carbonatite
카보런덤 : carborundum
카보우르 : cavour
카보이 : carboy
카본 : carbon
카불 : kabul
카뷰레터 : carburetor
카브랄 : cabral
카빈다 : cabinda
카빙 : carving
카사노바 : casanova
카사부부 : kasavubu
카사블랑카 : casablanca
카산드라 : kassandra
카상드르 : cassandre
카생 : cassin
카세인 : casein
카섹시스 : cathexis
카셀 : carcel
카셀 : cassel
카셈 : kassem
카소나 : casona
카수 : cassou
카슈니츠 : kaschnitz
카슈미르 : kashmir
카스카라 : cascara
카스타닌 : castanin
카스토르 : castor
카스트 : caste
카스틀러 : kastler
카스티야 : castilla
카스틸리오네 : castiglione
카시니 : cassini
카시러 : cassirer
카시오도루스 : cassiodorus
카시키스모 : caciquismo
카시트 : kassite
카야오 : callao
카예타누스 : cajetanus
카옌 : cayenne
카오스 : chaos
카올린 : kaolin
카우리 : kauri
카우보이 : cowboy
카우프만 : kauffmann
카운슬러 : counselor
카운슬링 : counselling
카운터블로 : counterblow
카운터펀치 : counterpunch
카운터포인트 : counterpoint
카운트 : count
카운트아웃 : countout
카울리 : cowley
카유테 : cailletet
카유푸티 : cajuputi
카이로 : cairo
카이로네이아 : chaeroneia
카이만 : caiman
카이사르 : caesar
카이세리 : kayseri
카이스트 : kaist
카이저 : keiser
카이절링 : keyserling
카이텔 : keitel
카이트 : kite
카인 : cain
카자드쥐 : casadesus
카자크 : kasack
카자흐 : kazakh
카자흐스탄 : kazakhstan
카잔차키스 : kazantzakis
카조리 : cajori
카즈빈 : qazvin
카추샤 : katyusha
카치니 : caccini
카코딜 : cacodyl
카타니아 : catania
카타르 : catarrh
카타르 : qatar
카타리나 : catharina
카타예프 : kataev
카탈로그 : catalogue
카탕가 : katanga
카터 : carter
카턴 : carton
카테콜 : catechol
카테콜아민 : catecholamine
카텝신 : kathepsin
카토비체 : katowice
카툴루스 : catullus
카트라이트 : cartwright
카트리지 : cartridge
카트만두 : kathmandu
카틸리나 : catilina
카파 : kappa
카파도키아 : cappadocia
카페인 : caffeine
카펜터 : carpenter
카펠라 : capella
카포네 : capone
카포디스트리아스 : kapodistrias
카포트 : carport
카푸아 : capua
카푸아나 : capuana
카프 : kapf
카프레오마이신 : capreomycin
카프로락탐 : caprolactam
카프리비 : caprivi
카프카스 : kavkaz
카피 : copy
카피라이터 : copywriter
카필라 : kapila
카하마르카 : cajamarca
칸 : cannes
칸 : khan
칸나 : canna
칸나비디올 : cannabidiol
칸니차로 : cannizzaro
칸다하르 : kandahar
칸델라 : candela
칸타로스 : kantharos
칸타리딘 : cantharidin
칸타리스 : cantharis
칸토로비치 : kantorovich
칸토어 : cantor
칸푸르 : kanpur
칼간 : kalgan
칼그렌 : karlgren
칼라 : calla
칼라 : collar
칼라디움 : caladium
칼라민 : calamine
칼라바르 : calabar
칼라스 : callas
칼라일 : carlisle
칼라테아 : calathea
칼라파 : calappa
칼럼 : column
칼럼니스트 : columnist
칼레 : calais
칼레미에 : kalemie
칼레발라 : kalevala
칼로 : callot
칼로리 : calorie
칼로리미터 : calorimeter
칼론 : calonne
칼루나이트 : kalunite
칼루트론 : calutron
칼리 : cali
칼리굴라 : caligula
칼리나이트 : kalinite
칼리닌 : kalinin
칼리도나이트 : calidonite
칼리마코스 : callimachos
칼리만탄 : kalimantan
칼리아리 : cagliari
칼리크라테스 : callicrates
칼리크레인 : callicrein
칼리파 : khaliifa
칼리포르늄 : californium
칼리프 : caliph
칼링가 : kalinga
칼마르 : kalmar
칼메트 : calmette
칼모틴 : calmotin
칼미아 : kalmia
칼미크 : kalmyk
칼뱅 : calvin
칼베 : calv
칼비노 : calvino
칼슘 : calcium
칼시민 : calcimine
칼시토닌 : calcitonin
칼크 : calc
칼파수트라 : kalpasutra
칼팍스 : kalfax
칼피스 : calpis
칼훈 : calhoun
캄보 : combo
캄파넬라 : campanella
캄팔라 : kampala
캄페르 : camper
캄펜 : camphene
캄포 : campo
캄포마네스 : campomanes
캄푸치아 : kampuchea
캄프토사우루스 : camptosaurus
캄플라주 : camouflager
캄필리 : campigli
캅사이신 : capsaicin
캅테인 : kapteyn
캉글리 : kangli
캉돌 : candolle
캉캉 : cancan
캐나다 : canada
캐나디안 : canadian
캐넌 : cannon
캐니언 : canyon
캐닝 : canning
캐드 : cad
캐디 : caddie
캐러더스 : carothers
캐러웨이 : caraway
캐러콜라이트 : caracolite
캐럴 : carol
캐럿 : carat
캐리 : carry
캐리어 : carrier
캐리커처 : caricature
캐릭터 : character
캐링 : carrying
캐멀 : camel
캐미솔 : camisole
캐번디시 : cavendish
캐벗 : cabot
캐비닛 : cabinet
캐비테이션 : cavitation
캐소드 : cathode
캐슈 : cashew
캐스케이드 : cascade
캐스터네츠 : castanets
캐스트 : cast
캐스트리스 : castries
캐슬레이 : castlereagh
캐시 : cash
캐시미어 : cashmere
캐시토미터 : cathetometer
캐주얼 : casual
캐처 : catcher
캐터펄트 : catapult
캐터플렉시 : cataplexy
캐터필러 : caterpillar
캐티네이션 : catenation
캐플린 : capeline
캔디 : kandy
캔버라 : canberra
캔버스 : canvas
캔터베리 : canterbury
캔트 : cant
캔틸레버 : cantilever
캘굴리 : kalgoorlie
캘러버라이트 : calaverite
캘러스 : callus
캘리도니언 : caledonian
캘리컷 : calicut
캘리코 : calico
캘리퍼스 : callipers
캘빈 : calvin
캘커타 : calcutta
캠 : cam
캠던 : camden
캠릿 : camlet
캠벨 : campbell
캠코더 : camcorder
캠퍼 : camphor
캠페인 : campaign
캠프 : camp
캠프파이어 : campfire
캡션 : caption
캡소미어 : capsomere
캡슐 : capsule
캡시드 : capsid
캡처 : capture
캡타이어 : cabtyre
캡틴 : captain
캥거루 : kangaroo
캬흐타 : kyakhta
커너코바이트 : kurnakovite
커넥터 : connector
커닝엄 : cunningham
커드 : curd
커드워스 : cudworth
커런시 : currency
커런트 : current
커마 : kerma
커머셜 : commercial
커뮤널리즘 : communalism
커뮤니케 : communique
커뮤니터스 : communitus
커뮤니티 : community
커뮤터 : commuter
커미션 : commission
커밍스 : cummings
커버 : cover
커버링 : covering
커버올스 : coveralls
커버트 : covert
커브 : curve
커서 : cursor
커스터드 : custard
커지 : kersey
커진치 : kazinczy
커켁시 : cachexy
커터나이트 : cotunnite
커텔 : cattell
커트 : cut
커틀릿 : cutlet
커티너리 : catenary
커티스 : curtis
커포티 : capote
커프스 : cuffs
커플링 : coupling
커피포트 : coffeepot
컨 : kern
컨덕턴스 : conductance
컨버터블 : convertible
컨버트 : convert
컨베이어 : conveyor
컨설팅 : consulting
컨세셔너리 : consessionary
컨소시엄 : consortium
컨스터블 : constable
컨테이너 : container
컨트롤 : control
컨트리 : country
컨틴전시 : contingency
컬 : curl
컬러 : curler
컬러리스트 : colorist
컬럼바이트 : columbite
컬레이저 : chalaza
컬렉션 : collection
컬렉터 : collector
컬티베이터 : cultivator
컴백 : comeback
컴벌랜드 : cumberland
컴파일러 : compiler
컴파트먼트 : compartment
컴퍼스 : compass
컴포넌트 : component
컴퓨터 : computer
컴프레서 : compressor
컴플라이언스 : compliance
컵 : cup
컵케이크 : cupcake
컷아웃 : cutout
컷오프 : cutoff
컷워크 : cutwork
케냐 : kenya
케냐타 : kenyatta
케널리 : kennelly
케노트론 : kenotron
케라토사우루스 : ceratosaurus
케레스 : ceres
케렌스키 : kerenskii
케로겐 : kerogen
케루악 : kerouac
케르만 : kerman
케르셴슈타이너 : kerschensteiner
케르키라 : kerkira
케만체 : kemanche
케말 : kemal
케모스타트 : chemostat
케미그라운드 : chemiground
케미컬 : chemical
케셀 : kessel
케스타 : cuesta
케스틀러 : koestler
케어드 : caird
케어리 : carey
케어리 : cary
케이 : kay
케이 : key
케이론 : cheiron
케이블그램 : cablegram
케이스 : case
케이스메이트 : casemate
케이스워크 : casework
케이슨 : caisson
케이싱 : casing
케이지 : cage
케이크 : cake
케이크워크 : cakewalk
케이폭 : kapok
케이프 : cape
케인 : cain
케일 : kale
케임브리지 : cambridge
케코넨 : kekkonen
케크롭스 : cecrops
케타민 : ketamine
케토오스 : ketose
케토코나졸 : ketoconazole
케토헥소오스 : ketohexose
케톨 : ketol
케트살테낭고 : quetzaltenango
케틀 : kettle
케틸 : ketyl
케페라 : khepera
케페우스 : cepheus
켄다리 : kendari
켄들 : kendall
켄타우로스 : centauros
켄타우리 : centauri
켄턴 : kenton
켈러 : keller
켈로그 : kellogg
켈로이드 : keloid
켈리 : kelly
켈밋 : kelmet
켈빈 : kelvin
켈수스 : celsus
켈프 : kelp
켐니츠 : chemnitz
켐블 : kemble
켐피스 : kempis
코간 : kogan
코기 : corgi
코나라크 : konarak
코나크리 : conakry
코냐크 : cognac
코너링 : cornering
코넌트 : conant
코넷 : cornet
코노돈트 : conodont
코노스코프 : conoscope
코니스 : cornice
코니아 : konya
코니컬 : conical
코더 : coder
코데인 : codeine
코덱스 : codex
코돈 : codon
코드 : chord
코드 : code
코디네이터 : coordinator
코딩 : coding
코라치니 : corazzini
코란 : koran
코랄 : chorale
코러스 : chorus
코레오그래퍼 : choreographer
코레조 : correggio
코렌스 : correns
코로 : corot
코로나 : corona
코로나그래프 : coronagraph
코로르 : koror
코롤렌코 : korolenko
코루나 : koruua
코르네유 : corneille
코르네이추크 : korneichuk
코르넬리아 : cornelia
코르닐로프 : kornilov
코르더 : korda
코르데 : corday
코르딜리네 : cordyline
코르사바드 : khorsabad
코르사코프 : korsakov
코르크 : cork
코르크스크루 : corkscrew
코르타사르 : cortazar
코르토 : cortot
코르토나 : cortona
코르티손 : cortisone
코르티코스테로이드 : corticosteroid
코르티코스테론 : corticosterone
코르티코이드 : corticoid
코르푸 : corfu
코리 : cori
코리슘 : corycium
코리올리 : coriolis
코린토스 : corinthos
코린트 : corinth
코만치 : comanche
코머 : comber
코먼 : common
코먼웰스 : commonwealth
코메니우스 : comenius
코메콘 : comecon
코모로 : comoros
코물 : qomul
코뮌 : commune
코미디 : comedy
코미스코 : comisco
코믹 : comic
코민테른 : comintern
코민트 : comint
코민포름 : cominform
코발레프스카야 : kovalevskaya
코발트 : cobalt
코번트리 : coventry
코브 : cobb
코브던 : cobden
코브도 : kobdo
코빗 : cobbett
코사 : cossa
코사크 : cossack
코세크 : cosec
코센차 : cosenza
코슈트 : kossuth
코스 : course
코스마 : kosma
코스모스 : cosmos
코스모트론 : cosmotron
코스모폴리탄 : cosmopolitan
코스튬 : costume
코스트 : coast
코스트 : cost
코스파 : cospar
코시 : cauchy
코시긴 : kosygin
코아세르베이션 : coacervation
코아세르베이트 : coacervate
코알라 : koala
코엔 : cohen
코엔트로 : coentro
코오퍼러티브 : cooperative
코이네 : koin
코이닝 : coining
코이터 : coiter
코일 : coil
코임바토르 : coimbatore
코임브라 : coimbra
코자이트 : coesite
코즈모폴리터니즘 : cosmopolitanism
코즐로프 : kozlov
코차밤바 : cochabamba
코체부 : kotzebue
코치 : coach
코친 : cochin
코카서스 : caucasus
코카이트 : cokeite
코카인 : cocaine
코칸트 : kokand
코코슈카 : kokoschka
코코아 : cocoa
코콜리스 : cocolith
코크 : cork
코크런 : cochrane
코크스 : cokes
코키나 : coquina
코킴보 : coquimbo
코킹 : caulking
코태트 : cotat
코터 : cotter
코텍스 : cortex
코트 : coat
코트 : cotte
코트 : court
코티 : coty
코팅 : coating
코파이바 : copaiba
코퍼 : copper
코퍼필드 : copperfield
코퍼헤드 : copperhead
코페르니쿠스 : copernicus
코펜하겐 : copenhagen
코포 : copeau
코프 : cope
코프 : kopp
코프라 : copra
코프카 : koffka
코하노프스키 : kochanowski
코핸 : cohan
코호트 : cohort
코흐 : koch
코히마 : kohima
콕 : cock
콕사키 : coxsackie
콕스웨인 : coxswain
콕슨리스 : coxswainless
콕시듐 : coccidium
콕크로프트 : cockcroft
콕토 : cocteau
콘 : cohn
콘 : corn
콘덴서 : condenser
콘도 : condo
콘돔 : condom
콘드라이트 : chondrite
콘드라티예프 : kondratiev
콘드로마이세스 : chondromyces
콘드리오솜 : chondriosome
콘래드 : conrad
콘사이스 : concise
콘서트 : concert
콘서트마스터 : concertmaster
콘셉트 : concept
콘소넌스 : consonance
콘솔 : consol
콘술 : consul
콘스 : khons
콘스타치 : cornstarch
콘스탄탄 : constantan
콘스탄티노폴리스 : konstantinopolis
콘스탄티노플 : constantinople
콘시퀀트 : consequent
콘알부민 : conalbumin
콘월 : cornwall
콘젤리터베이트 : congeliturbate
콘코셀리스 : conchocelis
콘코이드 : conchoid
콘키올린 : conchiolin
콘타도라 : contadora
콘택트 : contact
콘트라바순 : contrabassoon
콘트라베이스 : contrabass
콘티 : conti
콘티뉴이티 : continuity
콘퍼런스 : conference
콘포르 : cawnpore
콜 : call
콜 : coal
콜 : col
콜더 : calder
콜드 : called
콜드 : cold
콜라 : cola
콜라겐 : collagen
콜라르 : kolar
콜라이트 : coalite
콜러 : kohler
콜럼버스 : columbus
콜레라 : cholera
콜레스테롤 : cholesterol
콜레스테릭 : cholesteric
콜레키스토키닌 : cholecystokinin
콜레트 : colette
콜레트 : collett
콜로네이드 : colonnade
콜로니 : colony
콜로니아 : colonia
콜로디온 : collodion
콜로부스 : colobus
콜로이드 : colloid
콜로파나이트 : collophanite
콜로포늄 : colophonium
콜론 : colon
콜롬비아 : colombia
콜루고 : colugo
콜리 : collie
콜리니 : coligny
콜리마 : colima
콜리스틴 : colistin
콜리신 : colicin
콜리지 : coleridge
콜린 : choline
콜린스 : collins
콜마르 : colmar
콜모고로프 : kolmogorov
콜베 : kolbe
콜베르 : colbert
콜비츠 : kollwitz
콜초프 : koltsov
콜트 : colt
콜포스코프 : colposcope
콜히친 : colchicine
콤마 : comma
콤바인드 : combined
콤트랙 : comtrac
콤팩트 : compact
콤퍼짓 : composite
콤프턴 : compton
콤플렉손 : complexon
콩고 : congo
콩그리브 : congreve
콩글리시 : konglish
콩도르세 : condorcet
콩디야크 : condillac
콩스탕 : constant
콩코드 : concord
콩쿠르 : concourse
콩트 : comte
콰리즈미 : khwarizmi
콰이어 : choir
쿠거 : cougar
쿠나우 : kuhnau
쿠데타 : coupdetat
쿠라레 : curare
쿠랑 : courant
쿠로팟킨 : kuropatkin
쿠르간 : kurgan
쿠르낭 : cournand
쿠르노 : cournot
쿠르베 : courbet
쿠르스크 : kursk
쿠르쿠민 : curcumine
쿠르틀린 : courteline
쿠르티우스 : courtius
쿠르티우스 : curtius
쿠마론 : coumarone
쿠마리 : kumari
쿠마린 : courmarin
쿠마이리 : kumayri
쿠머 : kummer
쿠멘 : cumene
쿠바 : cuba
쿠베르탱 : coubertin
쿠베바 : cubeba
쿠사누스 : cusanus
쿠세비츠키 : koussevitzky
쿠션 : cushions
쿠스코 : cuzco
쿠스쿠스 : cuscus
쿠에 : cou
쿠웨이트 : kuwait
쿠이비셰프 : kuibyshev
쿠인틸리아누스 : quintilianus
쿠쟁 : cousin
쿠즈네초프 : kuznetsov
쿠즈니차 : kuznitza
쿠칭 : kuching
쿠크리닉시 : kukryniksy
쿠토 : coutaud
쿠투조프 : kutuzov
쿠팡 : kupang
쿠퍼 : cowper
쿠페론 : cupferron
쿠폰 : coupon
쿠프랭 : couperin
쿠프린 : kuprin
쿠프먼스 : koopmans
쿡 : coke
쿡 : cook
쿤 : kuhn
쿤트 : kundt
쿨 : cool
쿨나 : khulna
쿨란 : kulan
쿨랑주 : coulanges
쿨로미터 : coulometer
쿨롱 : coulomb
쿨리 : cooley
쿨리 : coolie
쿨링 : cooling
쿰 : qum
쿼드 : quad
쿼터 : quarter
쿼터 : quota
쿼터백 : quarterback
퀀셋 : quonset
퀘벡 : quebec
퀘이사 : quasar
퀴날딘 : quinaldine
퀴노이드 : quinoid
퀴논 : quinone
퀴뇨 : cugnot
퀴니딘 : quinidine
퀴닌 : quinine
퀴륨 : curium
퀴리 : curie
퀴리누스 : quirinus
퀴즈 : quiz
퀵 : quick
퀵스텝 : quickstep
퀸텟 : quintet
퀸틀 : quintal
퀸히드론 : quinhydrone
큐 : cue
큐 : ku
큐라이트 : curite
큐빗 : cubit
큐섹 : cusec
큐스톨 : qstol
큐티클 : cuticle
큐틴 : cutin
큐폴라 : cupola
크네무 : khnemu
크노 : queneau
크누센 : knudsen
크니스 : knies
크라나흐 : cranach
크라수스 : crassus
크라스노봇스크 : krasnovodsk
크라스노야르스크 : krasnoyarsk
크라우스 : kraus
크라우제 : krause
크라우칭 : crouching
크라운 : crown
크라이스트처치 : christchurch
크라이슬러 : kreisler
크라이시스 : crisis
크라카우 : krakau
크라프트 : kraft
크래브 : crab
크래브 : crabbe
크래쇼 : crashaw
크래커 : cracker
크래킹 : cracking
크래프트 : craft
크랭코 : cranko
크랭크 : crank
크랭크샤프트 : crankshaft
크러셔 : crusher
크러스트 : crust
크러치 : crutch
크럼프턴 : crompton
크레디 : credi
크레디트 : credit
크레바스 : crevasse
크레브스 : krebs
크레상 : cressent
크레아틴 : creatine
크레오소트 : creosote
크레오솔 : creosol
크레이징 : crazing
크레이터 : crater
크레이프 : crape
크레인 : crane
크레졸 : cresol
크레치머 : kretschmer
크레펠트 : krefeld
크렐레 : crelle
크렘리놀로지 : kremlinology
크로그 : krogh
크로나카 : cronaca
크로낙시 : chronaxie
크로네커 : kronecker
크로노메트리 : chronometry
크로노스 : cronos
크로노스코프 : chronoscope
크로닌 : cronin
크로마토그래피 : chromatography
크로마토그램 : chromatogram
크로마트론 : chromatron
크로매틱 : chromatic
크로머 : cromer
크로모마이신 : chromomycin
크로스 : cross
크로스바 : crossbar
크로스헤드 : crosshead
크로이소스 : kroisos
크로이처 : kreutzer
크로이츠베르크 : kreutzberg
크로체 : croce
크로커다일 : crocodile
크로커스 : crocus
크로코딜 : krokodil
크로톤 : croton
크로포트킨 : kropotkin
크론슈타트 : kronshtadt
크롤 : crawl
크롤링 : crawling
크롬랭크 : crommelynck
크롬웰 : cromwell
크루거랜드 : krugerrand
크루스 : cruz
크루저 : cruiser
크루제이루 : cruzeiro
크루치코프스키 : kruczkowski
크루프 : croup
크루프 : krupp
크룩사이트 : crooksite
크룩스 : crookes
크리벨리 : crivelli
크리서스 : croesus
크리소스토무스 : chrysostomus
크리스마스 : christmas
크리스천 : christian
크리스털 : crystal
크리스토포루스 : christophorus
크리스토프 : christophe
크리스투스 : christus
크리스티 : christie
크리스티나 : christina
크리스티아니아 : christiania
크리스피 : crispi
크리시포스 : chrysippos
크리켓 : cricket
크리프 : creep
크리피지 : creepage
크리핑 : creeping
크릴로프 : krylov
크림 : cream
크림슨 : crimson
크립톤 : krypton
크메르 : khmer
크반츠 : quantz
크산토마이신 : xanthomycin
크산티페 : xanthippe
크세노크라테스 : xenocrates
크세노폰 : xenophon
크세노풀로스 : xenopoulos
크세니아 : xenia
크실로오스 : xylose
크실리딘 : xylidine
크테시폰 : ctesiphon
클라겐푸르트 : klagenfurt
클라도스포륨 : cladosporium
클라드니 : chladni
클라레인 : clarain
클라리넷 : clarinet
클라리오넷 : clarionet
클라미도모나스 : chlamydomonas
클라미디아 : chlamydia
클라분트 : klabund
클라비호 : clavijo
클라우디아누스 : claudianus
클라우디우스 : claudius
클라우지우스 : clausius
클라이나이트 : kleinite
클라이맥스 : climax
클라이밍 : climbing
클라이브 : clive
클라이스트 : kleist
클라이언트 : client
클라이젠 : claisen
클라이페다 : klaipeda
클라크 : clark
클라크 : clarke
클라페롱 : clapeyron
클래딩 : cladding
클래런던 : clarendon
클래식 : classic
클랙슨 : klaxon
클랜 : klan
클램프 : clamp
클러스터 : cluster
클러치 : clutch
클러터 : clutter
클럽 : club
클레 : klee
클레로 : clairaut
클레망소 : clemenceau
클레먼츠 : clements
클레멘티 : clementi
클레오파트라 : cleopatra
클레이 : clay
클레임 : claim
클레프 : clef
클레프트 : cleft
클렌징 : cleansing
클렘페러 : klemperer
클렙시드라 : clepsydra
클로니딘 : clonidine
클로닝 : cloning
클로델 : claudel
클로디우스 : clodius
클로라닐 : chloranil
클로라민 : chloramine
클로랄라아제 : chloralase
클로람페니콜 : chloramphenicol
클로렐라 : chlorella
클로로다인 : chlorodyne
클로로메탄 : chloromethane
클로로벤젠 : chlorobenzen
클로로시스 : chlorosis
클로로아세톤 : chloroacetone
클로로에탄 : chloroethane
클로로크루오린 : chlorocruorin
클로로테트라시클린 : chlorotetracycline
클로로티몰 : chlorothymol
클로로티오나이트 : chlorothionite
클로로포름 : chloroform
클로로프렌 : chloroprene
클로로필 : chlorophyll
클로로필라아제 : chlorophylase
클로로필린 : chlorophyllin
클로록시파이트 : chloroxiphite
클로르데인 : chlordane
클로르디아제폭시드 : chlordiazepoxide
클로르프로마진 : chlorpromazine
클로리토이드 : chloritoid
클로버 : clover
클로소이드 : clothoid
클로스 : cloth
클로트리마졸 : clotrimazole
클론 : clone
클론다이크 : klondike
클루에 : clouet
클루조 : clouzot
클루지 : cluj
클리너 : cleaner
클리노미터 : clinometer
클리노키네시스 : klinokinesis
클리닝 : cleaning
클리도노그래프 : klydonograph
클리블랜드 : cleveland
클리엔테스 : clientes
클리크 : cleek
클리타임네스트라 : clytaemnestra
클리트 : cleat
클리퍼 : clipper
클릭 : click
클린다마이신 : clindamycin
클린업 : cleanup
클린치 : clinch
클립 : clip
클립보드 : clipboard
클립아트 : clipart
클링커 : clincer
클링커 : clinker
키 : key
키나 : china
키네마 : kinema
키네스코프 : kinescope
키네오라마 : kineorama
키네토그래프 : kinetograph
키네틱 : kinetic
키네틴 : kinetin
키네파노라마 : kinepanorama
키노포름 : chinoform
키뉴레닌 : kynureine
키니식스 : kinesics
키드 : kidd
키드 : kyd
키드니 : kidney
키레네 : cyrene
키로가 : quiroga
키로보그라드 : kirovograd
키로프스크 : kirovsk
키론 : chiron
키루나 : kiruna
키르기스 : kirgiz
키르기스스탄 : kirgizstan
키르기지아 : kirgizia
키르케고르 : kierkegaard
키르쿠크 : kirkuk
키르허 : kircher
키르히호프 : kirchhoff
키리노 : quirino
키리바시 : kiribati
키릴로스 : kyrillos
키마이라 : chimaera
키메라 : chimera
키모신 : chymosin
키모트립시노겐 : chymotrypsinogen
키모트립신 : chymotrypsin
키벨레 : cybele
키보드 : keyboard
키부츠 : kibbutz
키비 : kivi
키상가니 : kisangani
키수무 : kisumu
키슬링 : kisling
키슬링 : kissling
키시네프 : kishinev
키앙 : kiang
키어 : keyer
키어 : kier
키위 : kiwi
키잉 : keying
키저라이트 : kieserite
키츠 : keats
키치 : kitch
키치너 : kitchener
키친 : kitchin
키카데오이데아 : cycadeoidea
키케로 : cicero
키킹 : kicking
키타이 : khitai
키타이 : kitai
키톤 : chiton
키트 : kit
키트웨 : kitwe
키퍼 : keeper
키프 : keep
키프로스 : kypros
키플링 : kipling
키핑 : keeping
키홀 : keyhole
킥복싱 : kickboxing
킥볼 : kickball
킥아웃 : kickout
킨 : kean
킨디 : kindi
킨샤사 : kinshasa
킨카주 : kinkajou
킬 : keel
킬 : kiel
킬레이트 : chelate
킬로 : kilo
킬로그램미터 : kilogrammeter
킬로그램칼로리 : kilogramcalorie
킬로리터 : kiloliter
킬로미터 : kilometer
킬로미트리 : chelometry
킬로바 : kilobar
킬로볼트 : kilovolt
킬로볼트미터 : kilovoltmeter
킬로사이클 : kilocycle
킬로암페어 : kiloampere
킬로옴 : kilohm
킬로와트 : kilowatt
킬로칼로리 : kilocalorie
킬로퀴리 : kilocurie
킬로톤 : kiloton
킬로헤르츠 : kilohertz
킬케니 : kilkenny
킬트 : kilt
킴벌라이트 : kimberlite
킴벌리 : kimberley
킹 : king
킹스턴 : kingston
킹즐리 : kingsley
킹크 : kinck
타간로크 : taganrog
타고르 : tagore
타기팅 : targeting
타나그라 : tanagra
타나나리보 : tananarivo
타나토스 : thanatos
타라곤 : tarragon
타라불루스 : tarabulus
타라사 : tarrasa
타란토 : taranto
타렌툼 : tarentum
타르 : tar
타르드 : tarde
타르바간 : tarbagan
타르타로스 : tartaros
타르탈리아 : tartaglia
타르튀프 : tartuffe
타마린 : tamarin
타마린드 : tamarind
타마요 : tamayo
타목시펜 : tamoxifen
타무가디 : thamugadi
타무즈 : tammuz
타바스코 : tabasco
타바코 : tobacco
타부 : taboo
타블로이드 : tabloid
타소 : tasso
타슈켄트 : tashkent
타우린 : taurine
타우시그 : taussig
타운 : town
타운센드 : townshend
타운즈빌 : townsville
타울러 : tauler
타월 : towel
타이 : tie
타이곤 : tigon
타이로프 : tairov
타이머 : timer
타이밍 : timing
타이어 : tire
타이즈 : taizz
타이츠 : tights
타이트 : tight
타이틀 : title
타이프라이터 : typewriter
타이피스트 : typist
타이핑 : typing
타일러 : tylor
타임 : time
타임래그 : timelag
타임셰어링 : timesharing
타임스 : times
타입 : type
타지크 : tadzhik
타지키스탄 : tadzhikistan
타칸 : tacan
타크나 : tacna
타키온 : tachyon
타키투스 : tacitus
타킹턴 : tarkington
타타르 : tatar
타탄 : tartan
타틀린 : tatlin
타티오스 : tatios
탁실라 : taxila
탄제린 : tangerine
탄젠트 : tangent
탄젤로 : tangelo
탄탈라이트 : tantalite
탄탈로스 : tantalos
탈레랑 : talleyrand
탈로스 : talos
탈리도마이드 : thalidomide
탈리오니 : taglioni
탈마 : talma
탈무드 : talmud
탈카 : talca
탐 : tamm
탐보프 : tambov
탐페레 : tampere
탕가 : tanga
탕가니카 : tanganyika
탕구트 : tangut
태그 : tag
태런티즘 : tarantism
태머니 : tammany
태블러처 : tablature
태블릿 : tablet
태비 : tabby
태코그래프 : tachograph
태코미터 : tachometer
태클 : tackle
태팅 : tatting
태프트 : taft
태피스트리 : tapestry
태핏 : tappet
택 : tack
택손 : taxon
택시 : taxi
택시미터 : taximeter
택시스 : taxis
탠덤 : tandem
탤러해시 : tallahassee
탤런트 : talent
탤벗 : talbot
탤컴 : talcum
탤크 : talc
탬파 : tampa
탬핑 : tamping
탭 : tap
탱커 : tanker
탱크 : tank
터그보트 : tugboat
터너 : turner
터널 : tunnel
터닙 : turnip
터먼 : terman
터미널 : terminal
터보 : turbo
터보건 : toboggan
터보제트 : turbojet
터보팬 : turbofan
터보프롭 : turboprop
터부 : taboo
터비도스탯 : turbidostat
터빈 : turbine
터빙 : tubbing
터치 : touch
터치다운 : touchdown
터치라인 : touchline
터코마 : tacoma
터키 : turkey
터프 : tuff
턱시도 : tuxedo
턴 : turn
턴버클 : turnbuckle
턴키 : turnkey
턴테이블 : turntable
털리도 : toledo
텀 : term
텀블러 : tumbler
텀블링 : tumbling
텅스텐 : tungsten
텅잉 : tonguing
테구시갈파 : tegucigalpa
테넌트 : tennant
테네리프 : teneriffe
테니르스 : teniers
테니슨 : tennyson
테다 : taeda
테라리엄 : terrarium
테라바이트 : terabyte
테러 : terror
테러리즘 : terrorism
테러핌 : teraphim
테레민 : theremin
테레지나 : teresina
테레지아 : theresia
테렌티우스 : terentius
테르모필레 : thermopylae
테르밋 : thermit
테르보르히 : terborch
테르콤 : tercom
테르툴리아누스 : tertullianus
테르펜 : terpene
테리 : terry
테리어 : terrier
테리토리 : territory
테마 : thema
테미스 : themis
테미스토클레스 : themistocles
테베 : thebae
테살리아 : thessalia
테세우스 : theseus
테스 : tess
테스터 : tester
테스토스테론 : testosterone
테스피스 : thespis
테슬라 : tesla
테오그니스 : theognis
테오도루스 : theodorus
테오도리쿠스 : theodoricus
테오도리크 : theodoric
테오브로민 : theobromin
테오크리토스 : theocritos
테오프라스토스 : theophrastos
테이레시아스 : teiresias
테이블 : table
테이텀 : tatum
테이트 : tate
테이퍼 : taper
테이핑 : taping
테일 : tael
테일러 : taylor
테크네튬 : technetium
테크네트론 : technetron
테크노미스트 : technomist
테크노스트럭처 : technostructure
테크노스트레스 : technostress
테크노크라시 : technocracy
테크놀러지 : technology
테크놀로지 : technology
테크니라마 : technirama
테크니컬러 : technicolor
테크닉 : technic
테크론 : techron
테타노스파즈민 : tetanospasmin
테타놀리진 : tetanolysin
테타니 : tetany
테트라디마이트 : tetradymite
테트라시클린 : tetracycline
테트라젠 : tetrazene
테트라코드 : tetrachord
테트라코산 : tetracosane
테트라클로로메탄 : tetrachloromethane
테트라포드 : tetrapod
테트라히메나 : tetrahymena
테트락 : tetrac
테트로오스 : tetrose
테트릴 : tetryl
테티스 : tethys
테프라 : tephra
테프라이트 : tephrite
테프로크로놀로지 : tephrochronology
테헤란 : teheran
텍사스 : texas
텍스트 : text
텍토나이트 : tectonite
텍토노미터 : tectonometer
텍토닉스 : tectonics
텐 : ten
텐더로인 : tenderloin
텐돈 : tendon
텐렉 : tenrec
텐서 : tensor
텐션 : tension
텐트 : tent
텔 : tell
텔넷 : telnet
텔레고니 : telegony
텔레라이터 : telewriter
텔레마코스 : telemachos
텔레만 : telemann
텔레머 : telemer
텔레메디신 : telemedicine
텔레미터링 : telemetering
텔레비전 : television
텔레시오 : telesio
텔레타이프 : teletype
텔레타이프라이터 : teletypewriter
텔레텍스 : teletex
텔레파시 : telepathy
텔레팩스 : telefax
텔레포테이션 : teleportation
텔레폰 : telephone
텔레프린터 : teleprinter
텔레피션 : telefission
텔렉스 : telex
텔로젠 : telogen
텔롭 : telop
텔퍼 : telpher
템퍼링 : tempering
템포 : tempo
템플 : temple
텝 : tepp
토고 : togo
토골란드 : togoland
토나카이 : tonakai
토너 : toner
토너먼트 : tournament
토네이도 : tornado
토니 : tawney
토닉 : tonic
토드 : todd
토러스 : torus
토런스 : torrens
토레니아 : torenia
토렐리 : torelli
토론 : thoron
토론토 : toronto
토륨 : thorium
토르 : thor
토르 : torr
토르소 : torso
토리노 : torino
토리첼리 : torricelli
토마 : thomas
토마스 : thomas
토마지우스 : thomasius
토마호크 : tomahawk
토머스 : thomas
토모그래피 : tomography
토버나이트 : torbanite
토브랄코 : tobralco
토션 : torsion
토스 : toss
토스카넬리 : toscanelli
토스터 : toaster
토스티 : tosti
토아마시나 : toamasina
토인비 : toynbee
토치 : torch
토카막 : tokamak
토크 : talk
토크 : toque
토크 : torque
토키 : talkie
토털 : total
토테미즘 : totemism
토파즈 : topaz
토퍼 : topper
토펠리우스 : topelius
토폴로지 : topology
토플 : toefl
토플리스 : topless
토픽 : topic
토핑 : topping
톡소이드 : toxoid
톡소호르몬 : toxohormone
톤 : ton
톤 : tone
톨러 : toller
톨런드 : toland
톨레도 : toledo
톨레이아이트 : tholeiite
톨루엔 : toluene
톨루이딘 : toluidine
톨리아티 : togliatti
톨부타미드 : tolbutamide
톨스토이 : tolstoi
톨킨 : tolkien
톰 : thom
톰센 : thomsen
톰스크 : tomsk
톰슨 : thomson
톱 : top
톱코트 : topcoat
통가 : tonga
통북투 : tombouctou
통킹 : tongking
투 : to
투레 : tour
투렌 : touraine
투르 : tours
투르말린 : tourmaline
투르쿠 : turku
투르크메니스탄 : turkmenistan
투르키스탄 : turkistan
투른발트 : thurnwald
투바 : tuva
투발루 : tuvalu
투베로즈 : tuberose
투베르쿨린 : tuberculin
투손 : tucson
투키디데스 : thucydides
투탕카멘 : tutankhamen
투파이아 : tupaia
투폴레프 : tupolev
투피크 : tupik
툰드라 : tundra
툴 : tool
툴 : toul
툴레 : thule
툴롱 : toulon
툴루이 : tului
툴륨 : thulium
퉁구 : toungoo
튀니스 : tunis
튀르고 : turgot
튀일리 : tuileries
튜너 : tuner
튜닉 : tunic
튜닝 : tuning
튜더 : tudor
튜멘 : tyumen
튜바 : tuba
튜불린 : tubulin
튜체프 : tyutchev
튤립 : tulip
트 : llobregat
트라브존 : trabzon
트라야누스 : trajanus
트라이 : try
트라이앵글 : triangle
트라이어드 : triad
트라이얼 : trial
트라케 : thrace
트라코돈 : trachodon
트라코마 : trachoma
트라키아 : thracia
트란스발 : transvaal
트란스요르단 : transjordan
트란실바니아 : transylvania
트래거캔스 : tragacanth
트래버스 : traverse
트래블러 : traveler
트래블링 : travelling
트래지디 : tragedy
트래킹 : tracking
트래핑 : trapping
트랙 : track
트랙터 : tractor
트랜셉트 : transept
트랜스 : trance
트랜스시버 : transceiver
트랜스아미나아제 : transaminase
트랜스퍼 : transfer
트랜스페린 : transferrin
트랜스펙션 : transfection
트랜싯 : transit
트랜잭션 : transaction
트랜지스터 : transistor
트램펄린 : trampolin
트랩 : trap
트랩슈팅 : trapshooting
트러스 : truss
트러스트 : trust
트럭 : truck
트럼프 : trump
트렁크 : trunk
트렁크스 : trunks
트레비식 : trevithick
트레오닌 : threonine
트레이너 : trainer
트레이닝 : training
트레이더 : trader
트레이드 : trade
트레이싱 : tracing
트레인 : train
트레일러 : trailer
트레포네마 : treponema
트렌델렌부르크 : trendelenburg
트렌처 : trencher
트렌토 : trento
트렌트 : trent
트로나 : trona
트로바토레 : trovatore
트로야 : troja
트로이 : troy
트로일로스 : troelos
트로코이드 : trochoid
트로키 : troche
트로포니오스 : trophonios
트로포닌 : troponin
트로포콜라겐 : tropocollagen
트로폴론 : tropolone
트로피 : trophy
트로피컬 : tropical
트론 : tron
트론헤임 : trondheim
트롤럽 : trollope
트롤리 : trolley
트롤링 : trolling
트롬보스테닌 : thrombostenin
트롬보플라스틴 : thromboplastin
트롬본 : trombone
트롯 : trot
트뢸치 : troeltsch
트루로 : truro
트루스타이트 : troostite
트루아 : troyes
트루히요 : trujillo
트리 : tree
트리고니아 : trigonia
트리글리프 : triglyph
트리니트로톨루엔 : trinitrotoluene
트리닐 : trinil
트리메타디온 : trimethadione
트리메틸렌트리니트라민 : trimethylenetrinitramine
트리밍 : trimming
트리반드룸 : trivandrum
트리보니아누스 : tribonianus
트리비얼리즘 : trivialism
트리스트럼 : tristram
트리암시놀론 : triamcinolone
트리암테렌 : triamterene
트리엔날레 : triennale
트리엔트 : trient
트리오 : trio
트리케라톱스 : triceratops
트리코데르마 : trichoderma
트리코마이신 : trichomycin
트리클렌 : trichlene
트리클로로메탄 : trichloromethane
트리클로로에틸렌 : trichloroethylene
트리튬 : tritium
트리파노소마 : trypanosoma
트리파플라빈 : trypaflavine
트리폴리 : tripoli
트리폴리타니아 : tripolitania
트리플 : triple
트리핑 : tripping
트리할로메탄 : trihalomethane
트릭 : trick
트릴 : trill
트림 : thrym
트림 : trim
트립시노겐 : trypsinogen
트립신 : trypsin
트립토판 : tryptophan
트립틱 : triptych
트링코말리 : trincomalee
트바르도프스키 : tvardovskii
트와이닝 : twining
트와일라이트 : twilight
트웨인 : twain
티 : tea
티 : tee
티가든 : teagarden
티라나 : tirana
티라노사우루스 : tyrannosaurus
티라민 : tyramine
티로시나아제 : tyrosinase
티록신 : thyroxine
티루스 : tyrus
티르 : tyr
티르타이오스 : tyrtaeos
티린스 : tiryns
티메로살 : thimerosal
티몬 : timon
티몰 : thymol
티미랴제프 : timiryazev
티민 : thymine
티밍 : teeming
티베리우스 : tiberius
티베트 : tibet
티보 : thibaud
티보데 : thibaudet
티볼리 : tivoli
티불루스 : tibullus
티슈바인 : tischbein
티스푼 : teaspoon
티아마트 : tiamat
티아우아나코 : tiahuanaco
티아조술폰 : thiazosulfone
티에르 : thiers
티에폴로 : tiepolo
티오나프텐 : thionaphthen
티오시안 : thiocyan
티오알코올 : thioalcohol
티오에테르 : thioether
티오우라실 : thiouracil
티오카르바미드 : thiocarbamid
티오콜 : thiokol
티오테파 : thiotepa
티오펜 : thiophen
티옴킨 : tiomkin
티치너 : titchener
티커 : ticker
티케 : tyche
티크 : teak
티크 : tieck
티타나이트 : titanite
티타니아 : titania
티탄 : titan
티토 : tito
티토노스 : tithonos
티투스 : titus
티푸스 : typhus
티플리스 : tiflis
티호노프 : tikhonov
티후아나 : tijuana
틴 : teen
틴들 : tyndale
틴들 : tyndall
틴캘코나이트 : tincalconite
틴토레토 : tintoretto
틴트 : tint
틸라피아 : tilapia
틸레 : tiele
틸리히 : tillich
팀 : team
팀파눔 : typanum
팀파니스트 : timpanist
팁 : tip
파 : par
파가니니 : paganini
파게 : faguet
파고다 : pagoda
파곳 : fagott
파나맥스 : panamax
파나비전 : panavision
파나이 : panay
파노라마 : panorama
파노프스키 : panofsky
파뇰 : pagnol
파당 : padang
파더스 : fathers
파데예프 : fadeev
파도바 : padova
파두츠 : vaduz
파라과이 : paraguay
파라나 : paran
파라다이스 : paradise
파라레드 : parared
파라마리보 : paramaribo
파라메디컬 : paramedical
파라미터 : parameter
파라볼라 : parabola
파라비오시스 : parabiosis
파라셀수스 : paracelsus
파라아세트알데히드 : paraacetaldehyde
파라알데히드 : paraldehyde
파라옥시아조벤젠 : paraoxyazobenzene
파라크산틴 : paraxanthine
파라크실렌 : paraxylene
파라포름알데히드 : paraformaldehyde
파라핀 : paraffin
파라헬륨 : parahelium
파란트로푸스 : paranthropus
파랄림픽 : paralympics
파레 : par
파렌하이트 : fahrenheit
파렐 : farel
파로틴 : parotin
파르메니데스 : parmenides
파르미자니노 : parmigianino
파르시팔 : parsifal
파르티아 : parthia
파리 : paris
파마구스타 : famagusta
파마퀸 : pamaquine
파모티딘 : famotidine
파브르 : fabre
파브리아노 : fabriano
파블로바 : pavlova
파사이 : pasay
파샤 : pasha
파섹 : parsec
파스 : farce
파스 : pas
파스너 : fastener
파스칼 : pascal
파스콜리 : pascoli
파스큘라 : paskyula
파스테르나크 : pasternak
파스텔 : pastel
파스토 : pasto
파슨스 : parsons
파슬리 : parsley
파시 : parsee
파시스트 : fascist
파시즘 : fascism
파야 : falla
파우사니아스 : pausanias
파우스토프스키 : paustovskii
파우스트 : faust
파운데이션 : foundation
파운드 : pound
파울 : foul
파울리 : pauli
파워 : power
파월 : powell
파이낸스 : finance
파이널 : final
파이닝어 : feininger
파이로필라이트 : pyrophyllite
파이버 : fiber
파이버보드 : fiberboard
파이살 : faisal
파이시엘로 : paisiello
파이어 : fire
파이오니오스 : paeonios
파이온 : pion
파이카 : pica
파이톤사이드 : phytoncide
파이프 : pipe
파이프라인 : pipeline
파인 : pine
파인더 : finder
파인먼 : feynman
파인트 : pint
파일 : file
파일 : pile
파일론 : pylon
파자마 : pajamas
파전 : farjeon
파지 : phage
파체코 : pacheco
파촐리 : patchouli
파카 : paca
파카 : parka
파커 : parker
파코미우스 : pachomius
파크 : park
파키스탄 : pakistan
파타고니아 : patagonia
파타니 : pattani
파탄 : patan
파토 : pato
파토스 : pathos
파톤 : parton
파트라스 : patras
파트레 : patre
파티션 : partition
파티시페이션 : participation
파티클 : particle
파파야 : papaya
파파인 : papain
파팽 : papain
파펜 : papen
파포스 : pappos
파푸아 : papua
파피루스 : papyrus
파허 : pacher
판겐 : pangen
판도라 : pandora
판도리나 : pandorina
판사 : panza
판첸 : panchen
판초 : poncho
판크라티움 : pancratium
판크레오지민 : pancreozymin
판타지 : fantasy
판테온 : pantheon
팔라디오 : palladio
팔라스 : pallas
팔라우 : palau
팔레르모 : palermo
팔레스타인 : palestine
팔레스트리나 : palestrina
팔렘방 : palembang
팔로피우스 : fallopius
팔리다 : pallida
팔리시 : palissy
팔마 : palma
팔메 : palme
팔미틴 : palmitin
팔코네 : falconet
팜 : farm
팜 : palm
팜파스 : pampas
팝 : pop
팝콘 : popcorn
팡타그뤼엘 : pantagruel
패널리스트 : panelist
패닉 : panic
패닝 : panning
패덤 : fathom
패드 : pad
패들 : paddle
패러글라이더 : paraglider
패러글라이딩 : paragliding
패러다이스 : paradise
패러데이 : faraday
패러독스 : paradox
패러디 : parody
패러프레이즈 : paraphrase
패럴 : farrell
패럴렐 : parallel
패럿 : farad
패리티 : parity
패링 : parrying
패밀리 : family
패서디나 : pasadena
패션 : fashion
패소미터 : passometer
패스 : pass
패스 : path
패스트 : fast
패스트 : passed
패스포트 : passport
패시지 : passage
패시피시즘 : pacificism
패키지 : package
패킹 : packing
패터슨 : paterson
패트릭 : patrick
팩 : pack
팩스 : fax
팩시밀리 : facsimile
팩터링 : factoring
팩티스 : factice
팬 : pan
팬지 : pansy
팬츠 : pants
팬크로매틱 : panchromatic
팬터그래프 : pantagraph
팬터마임 : pantomime
팬파이프 : panpipe
팰러틴 : palatine
팰리스 : palace
팰밋 : palmate
팸플릿 : pamphlet
팽르베 : painlev
퍼 : per
퍼거슨 : fergusson
퍼걸러 : pergola
퍼데틱 : pathetic
퍼레이드 : parade
퍼멀로이 : permalloy
퍼밀 : permill
퍼블리시티 : publicity
퍼블릭 : public
퍼센티지 : percentage
퍼셀 : pucell
퍼셀 : purcell
퍼스 : peirce
퍼스 : perth
퍼스널 : personal
퍼스티언 : fustian
퍼시픽 : pacific
퍼실라이트 : percylite
퍼커션 : percussion
퍼킨 : perkin
퍼터 : putter
퍼텐셜 : potential
퍼텐쇼미터 : potentiometer
퍼트 : pert
퍼티 : putty
퍼팅 : putting
퍼펙트 : perfect
퍼포레이션 : perforation
퍼포먼스 : performance
퍼프 : puff
펀더멘털리즘 : fundamentalism
펀드 : fund
펀자브 : punjab
펀치 : punch
펀칭 : punching
펀트 : punt
펄라이트 : pearlite
펄로크 : perlohrke
펄롱 : furlong
펄서 : pulsar
펄스 : pulse
펄프 : pulp
펌 : firm
펌블 : fumble
펌웨어 : firmware
펌프스 : pumps
펑크 : punk
펑키 : funky
페구 : pegu
페그마타이트 : pegmatite
페나세틴 : phenacetin
페난트렌 : phenanthrene
페낭 : penang
페널티 : penalty
페넬로페 : penelope
페노바르비탈 : phenobarbital
페놀프탈레인 : phenolphthalein
페니 : penny
페니나이트 : penninite
페니실린 : penicillin
페니웨이트 : pennyweight
페니키아 : phoenicia
페니페이퍼 : pennypaper
페닐부타존 : phenylbutazone
페닐알라닌 : phenylalanine
페더 : feather
페더레이션 : federation
페데 : feyder
페디큐어 : pedicure
페딘 : fedin
페라라 : ferrara
페라이트 : ferrite
페랭 : perrin
페럿 : ferret
페레다 : pereda
페렐 : ferrel
페로 : perrault
페로몬 : pheromone
페로바나듐 : ferrovanadium
페로세륨 : ferrocerium
페로알루미늄 : ferroaluminium
페로타이프 : ferrotype
페로텅스텐 : ferrotungsten
페루자 : perugia
페루지노 : perugino
페루치 : peruzzi
페르가나 : fergana
페르골레시 : pergolesi
페르디난트 : ferdinand
페르마 : fermat
페르모라이트 : fermorite
페르미 : fermi
페르비스트 : verbiest
페르세우스 : perseus
페르세폴리스 : persepolis
페르소 : persoz
페르시아 : persia
페르옥시솜 : peroxysome
페르웨이 : verwey
페르피냥 : perpignan
페리 : ferry
페리 : perry
페리도트 : peridot
페리보트 : ferryboat
페리클레스 : perikles
페리틴 : ferritin
페미니스트 : feminist
페미니즘 : feminism
페미컨 : pemmican
페샤와르 : peshawar
페서리 : pessary
페스 : fes
페스탈로치 : pestalozzi
페스트 : pest
페스티벌 : festival
페아노 : peano
페어 : fair
페어 : pair
페어링 : pairring
페어뱅크스 : fairbanks
페어웨이 : fairway
페이도 : feydeau
페이드 : fade
페이로드 : payload
페이비어니즘 : fabianism
페이스 : face
페이스메이커 : pacemaker
페이스트 : paste
페이시스트라토스 : peisistratos
페이크 : fake
페이터 : pater
페이튼 : phaeton
페이퍼백 : paperback
페인 : pain
페인 : paine
페인텍스 : paintex
페인트 : feint
페인트 : paint
페일 : fail
페잔 : fezzan
페카넨 : pekkanen
페키니즈 : pekinese
페킨파 : peckinpah
페테르부르크 : peterburg
페트 : fet
페트라 : petra
페트라르카 : petrarca
페트로비치 : petrovich
페트로자봇스크 : petrozavodsk
페트롤레이텀 : petrolatum
페트루스 : petrus
페티 : petty
페티시 : fetish
페티코트 : petticoat
페팅 : petting
페퍼 : pfeffer
페프스너 : pevsner
페플럼 : peplum
페히너 : fechner
펙 : peg
펙틴 : pectin
펜 : pen
펜더 : fender
펜던트 : pendant
펜듈럼 : pendulum
펜스 : pence
펜싱 : fencing
펜타곤 : pentagon
펜타에리트리톨 : pentaerythritol
펜타조신 : pentazocine
펜타클로로페놀 : pentachlorophenol
펜탄 : pentane
펜탄올 : phentanol
펜테실레이아 : penthesileia
펜테질레아 : penthesilea
펜텐 : pentene
펜토바르비탈 : pentobarbital
펜트리트 : penthrit
펜틸렌 : pentylene
펜팔 : penpal
펠라그라 : pellagra
펠라기우스 : pelagius
펠라르고니딘 : pelargonidin
펠레우스 : peleus
펠레타이징 : pelletizing
펠로피다스 : pelopidas
펠리오 : pelliot
펠리컨 : pelican
펠릿 : pellet
펠티에 : peltier
펩시노겐 : pepsinogen
펩신 : pepsin
펩티도글리칸 : peptidoglycan
펩티드 : peptide
펩티제이션 : peptization
포 : four
포 : poe
포가차로 : fogazzaro
포겔 : vogel
포노스코프 : phonoscope
포놀라이트 : phonolite
포니 : pony
포니테일 : ponytail
포도필룸 : podophyllum
포드 : ford
포드고르니 : podgorny
포디즘 : fordism
포럴 : poral
포럼 : forum
포레스터 : forester
포렐 : forel
포르 : fort
포르스만 : forssmann
포르스트 : forst
포르켈 : forkel
포르탈레자 : fortaleza
포르투갈 : portugal
포르피리오스 : porphyrios
포르핀 : porphine
포름알데히드 : formaldehyde
포리 : pori
포마드 : pomade
포마이카 : formica
포마토 : pomato
포맷 : format
포메라니아 : pomerania
포메라니안 : pomeranian
포메이션 : formation
포모제 : pomorze
포뮬러 : formula
포브스 : fobs
포사다 : posada
포세이돈 : poseidon
포슈 : foch
포스 : force
포스 : pos
포스 : voss
포스겐 : phosgene
포스토이나 : postojna
포스트 : post
포스트모더니즘 : postmodernism
포스파겐 : phosphagen
포스파티드 : posphatide
포스파티딜 : phosphatidyl
포스포크레아틴 : phosphocreatine
포스핀 : phosphin
포어그라운드 : foreground
포워드 : forward
포위스 : powys
포이어바흐 : feuerbach
포인세티아 : poinsettia
포인터 : pointer
포인트 : point
포일 : foil
포젠 : posen
포즈 : pause
포지션 : position
포지트로늄 : positronium
포지트론 : positron
포츠담 : potsdam
포츠머스 : portsmouth
포치 : porch
포커 : poker
포커스 : focus
포컬 : focal
포켓볼 : pocketball
포크 : folk
포크너 : faulkner
포크리프트 : forklift
포크트 : vogt
포클레인 : poclain
포킨 : fokin
포타슘 : potassium
포터 : potter
포테이토 : potato
포텐자 : potenza
포토그램 : photogram
포토다이오드 : photodiode
포토레지스트 : photoresist
포토셀 : photocell
포토스탯 : photostat
포토시 : potosi
포토오더 : photoorder
포토저널리즘 : photojournalism
포토커플러 : photocoupler
포토키나 : photokina
포토타이프 : phototype
포토트랜지스터 : phototransistor
포토플레이 : photoplay
포톤 : photon
포트 : phot
포트 : pot
포트란 : fortran
포트리에 : fautrier
포틀랜드 : portland
포틀랩 : portlap
포티 : forty
포프 : pope
포플러 : poplar
포플린 : poplin
폭스 : fox
폭스트롯 : foxtrot
폰 : phon
폰다 : fonda
폰델 : vondel
폰비진 : fonvizin
폰키엘리 : ponchielli
폰타나 : fontana
폰타네 : fontane
폰토르모 : pontormo
폰토스 : pontos
폰토피단 : pontoppidan
폰트 : font
폰트랴긴 : pontryagin
폰티아나크 : pontianak
폴 : fall
폴 : paul
폴 : pole
폴더 : folder
폴더 : polder
폴라니 : polanyi
폴라로이드 : polaroid
폴라리스 : polaris
폴라이우올로 : pollaiuolo
폴레보이 : polevoi
폴로 : follow
폴로 : polo
폴록 : pollock
폴록사머 : poloxamer
폴룩스 : pollux
폴리그래프 : polygraph
폴리냐크 : polignac
폴리네시아 : polynesia
폴리데우케스 : polydeuces
폴리돌 : folidol
폴리리듬 : polyrhythm
폴리미터 : polymeter
폴리부타디엔 : polybutadiene
폴리부텐 : polybutene
폴리비전 : polivision
폴리센트리즘 : polycentrism
폴리스 : polis
폴리스티렌 : polystyrene
폴리시 : policy
폴리아민 : polyamine
폴리아세탈 : polyacetal
폴리에스테르 : polyester
폴리에틸렌 : polyethylene
폴리엔 : polyene
폴리예 : polije
폴리오 : polio
폴리오 : pollio
폴리오바이러스 : poliovirus
폴리우레탄 : polyurethane
폴리이소부틸렌 : polyisobutylene
폴리진 : polygene
폴리카르포스 : polycarpos
폴리카보네이트 : polycarbonate
폴리클레이토스 : polycleitos
폴리테크니즘 : polytechnism
폴리티컬 : political
폴리페닐 : polyphenyl
폴리펩티드 : polypeptide
폴리포니 : polyphony
폴리프로필렌 : polypropylene
폴링 : pauling
폴링 : polling
폴카 : polka
폴트 : fault
폼 : foam
폼페이 : pompeii
폼포나치 : pomponazzi
퐁디셰리 : pondicherry
퐁슬레 : poncelet
퐁텐블로 : fontainbleau
퐁파두르 : pompadour
푸가초프 : pugachov
푸나 : poona
푸나푸티 : funafuti
푸드 : pud
푸들 : poodle
푸딩 : pudding
푸란 : furan
푸르네롱 : fourneyron
푸르니에 : fournier
푸르키녜 : purkinjn
푸르푸랄 : furfural
푸리 : puri
푸리에 : fourier
푸린 : purine
푸사륨 : fusarium
푸샨 : pushan
푸셰 : fouch
푸슈킨 : pushkin
푸시로드 : pushrod
푸싱 : pushing
푸아송 : poisson
푸앵카레 : poincar
푸에룰루스 : puerulus
푸에블라 : puebla
푸줄리나 : fusulina
푸치니 : puccini
푸케 : fouqu
푸코 : foucault
푸크시아 : fuchsia
푸트 : foote
푸펜도르프 : pufendorf
푸핀 : pupin
푹신 : fuchsine
풀 : full
풀 : pool
풀리고 : fuligo
풀백 : fullback
풀브라이트 : fulbright
풀치 : pulci
풀턴 : fulton
풋 : foot
풋볼 : football
풋워크 : footwork
풋홀드 : foothold
퓨마 : puma
퓨전 : fusion
퓨즈 : fuse
퓰리처 : pulitzer
프놈펜 : pnompenh
프라 : fra
프라그 : prague
프라디오마이신 : fradiomycin
프라세오디뮴 : praseodymium
프라이 : fry
프라이머리 : primary
프라이밍 : priming
프라이부르크 : freiburg
프라이빗 : private
프라이스 : price
프라이온 : prion
프라이타크 : freytag
프라일리그라트 : freiligrath
프라조신 : prazosin
프라지콴텔 : praziquantel
프라카스토로 : fracastoro
프라하 : praha
프락시 : proxy
프락시텔레스 : praxiteles
프란체스코 : francesco
프란츠 : franz
프란틀 : prandtl
프랑슘 : francium
프랑스 : france
프랑케 : francke
프랑코 : franco
프랑크 : franck
프랑크 : frank
프래그머티즘 : pragmatism
프랙션 : fraction
프랙숀 : fraction
프랜차이즈 : franchise
프랭크퍼트 : frankfort
프랭클랜드 : frankland
프랭클린 : franklin
프러시아 : prussia
프러시안 : prussian
프러젝티브 : projective
프러포즈 : propose
프런트 : front
프레게 : frege
프레그넌스 : pregnance
프레글 : pregl
프레더릭턴 : fredericton
프레드니솔론 : prednisolon
프레리 : prairie
프레비시 : prebisch
프레스 : press
프레스 : presss
프레스코발디 : frescobaldi
프레스터 : prester
프레스턴 : preston
프레싱 : pressing
프레온 : freon
프레이르 : freyr
프레이야 : feyja
프레이저 : frazer
프레이즈 : fraise
프레젠테이션 : presentation
프레즈노 : fresno
프레퍼레이션 : preparation
프레폴리머 : prepolymer
프렌치 : french
프렘 : prem
프렛 : fret
프로게스테론 : progesterone
프로그래밍 : programming
프로그램 : program
프로그레시브 : progressive
프로덕션 : production
프로덕트 : product
프로듀서 : producer
프로락틴 : prolactin
프로망탱 : fromentin
프로메테우스 : prometheus
프로모션 : promotion
프로모터 : promoter
프로미넌스 : prominence
프로방스 : provence
프로베네시드 : probenecid
프로베니우스 : frobenius
프로비타민 : provitamin
프로빈키아 : provincia
프로세서 : processor
프로세싱 : processing
프로슈머 : prosumer
프로스타글란딘 : prostaglandin
프로시니엄 : proscenium
프로시딩 : proceeding
프로시아 : prossia
프로이트 : freud
프로젝터 : projector
프로젝트 : project
프로코피예프 : prokofiev
프로코피우스 : procopius
프로키온 : procyon
프로타고라스 : protagoras
프로타민 : protamine
프로테스탄티즘 : protestantism
프로테오스 : proteose
프로테우스 : proteus
프로토케라톱스 : protoceratops
프로토콜 : protocol
프로토플래스트 : protoplast
프로톱테루스 : protopterus
프로튬 : protium
프로트롬빈 : prothrombin
프로파간다 : propaganda
프로파논 : propanone
프로판 : propane
프로퍼 : proper
프로페르티우스 : propertius
프로펠러 : propeller
프로필 : profile
프로필렌 : propylene
프로필릿 : profilit
프록시마 : proxima
프롤라민 : prolamin
프롤레타리아 : proletariat
프롤로그 : prologue
프롤린 : proline
프롬 : fromm
프롬나드 : promenade
프롬프터 : prompter
프롬프트 : prompt
프루덴티우스 : prudentius
프루동 : proudhon
프루스 : prus
프루아사르 : froissart
프루츠 : fruits
프룬제 : frunze
프리 : free
프리가 : frigga
프리깃 : frigate
프리드리히 : friedrich
프리드리히스하펜 : friedrichshafen
프리리코딩 : prerecording
프리마퀸 : primaquine
프리맨틀 : freemantle
프리메이슨 : freemason
프리뮬러 : primula
프리미돈 : primidone
프리미티브 : primitive
프리미티비즘 : primitivism
프리부르 : fribourg
프리슈 : frisch
프리슈빈 : prishvin
프리스비 : frisbee
프리스트레스트 : prestressed
프리스틀리 : priestley
프리애니미즘 : preanimism
프리에스 : friesz
프리웨어 : freewear
프리웨이 : freeway
프리즘 : prism
프리지어 : freesia
프리체 : friche
프리타운 : freetown
프리탈룩스 : fritalux
프리터 : fritter
프리트 : fried
프리패브 : prefab
프리팩트 : prepacked
프린세스 : princess
프린스 : prince
프린스턴 : princeton
프린터 : printer
프린트 : print
프린팅 : printing
프림로즈 : primrose
프사이 : psi
프사이그 : psig
프실로피톤 : psilophyton
프타 : ptah
프테라노돈 : pteranodon
프테로사우루스 : pterosaurus
프톨레마이오스 : ptolemaeos
프티알린 : ptyalin
플라그스타 : flagstad
플라나리아 : planaria
플라네타륨 : planetarium
플라멩코 : flamenco
플라밍고 : flamingo
플라보노이드 : flavonoid
플라세보 : placebo
플라스마 : plasma
플라스마진 : plasmagene
플라스민 : plasmin
플라스크 : flask
플라스터 : plaster
플라스토좀 : plastosome
플라스틱 : plastic
플라야 : playa
플라우투스 : plautus
플라이 : fly
플라이우드 : plywood
플라이휠 : flywheel
플라잉 : flying
플라코드 : placode
플라텐 : platen
플라토노프 : platonov
플라토니즘 : platonism
플라티나이트 : platinite
플라티노이드 : platinoid
플랑드르 : flandre
플랑크 : planck
플랑크톤 : plankton
플래그 : flag
플래너 : planner
플래니미터 : planimeter
플래빈 : flavin
플래시 : flash
플래시백 : flashback
플래카드 : placard
플래토 : plateau
플래티나 : platina
플랜 : plan
플랜더스 : flanders
플랜지 : flange
플랜트 : plant
플램스티드 : flamsteed
플랩 : flap
플러그 : plug
플러드라이트 : floodlight
플러스 : plus
플러시 : plush
플러터 : flutter
플럭스 : flux
플럼비콘 : plumbicon
플레밍 : fleming
플레밍 : flemming
플레비사이트 : plebiscite
플레시안트로푸스 : plesianthropus
플레시오사우루스 : plesiosaurus
플레이 : play
플레이 : plays
플레이너 : planer
플레이서 : placer
플레이스킥 : placekick
플레이어 : player
플레이쿠 : pleiku
플레이트 : plate
플레인 : plane
플레처 : fletcher
플레처리즘 : fletcherism
플레하노프 : plekhanov
플렉소그래피 : flexography
플렉시블 : flexible
플렌스부르크 : flensburg
플로 : flow
플로라 : flora
플로리 : florey
플로리 : flory
플로리겐 : florigen
플로브디브 : plovdiv
플로어 : floor
플로어링 : flooring
플로터 : plotter
플로토 : flotow
플로트 : float
플로티노스 : plotinos
플로피 : floppy
플록스 : phlox
플루럴리즘 : pluralism
플루오레세인 : fluorescein
플루크 : fluke
플루타르크 : plutarch
플루테우스 : pluteus
플루토 : pluto
플루톤 : pluton
플루트 : flute
플루팅 : fluting
플리머스 : plymouth
플리스 : fleece
플릭텐 : phlycten
플린트 : flint
플젠 : plze
피겨 : figure
피구 : pigou
피그 : pig
피그미 : pygmy
피기백 : piggyback
피날레 : finale
피너클 : pinnacle
피네로 : pinero
피넬 : pinel
피니언 : pinion
피닉스 : phoenix
피닝 : peening
피들러 : fiedler
피라네시 : piranesi
피라노스 : pyranose
피라미드 : pyramid
피라비탈 : pyrabital
피라지나마이드 : pyrazinamide
피란델로 : pirandello
피란텔 : pyrantel
피레네 : pyrenees
피레우스 : piraeus
피레트린 : pyrethrin
피렌 : pirenne
피로 : pyro
피로갈롤 : pyrogallol
피로네마 : pyronema
피론 : pyrrhon
피롤 : pyrrole
피롬 : prom
피르 : pire
피르다우시 : firdausi
피르케 : pirquet
피리독사민 : pyridoxamine
피리독살 : pyridoxal
피리독신 : pyridoxine
피리딘 : pyridine
피리미딘 : pyrimidine
피벗 : pivot
피분 : phibun
피브로인 : fibroin
피브리노겐 : fibrinogen
피브릴 : fibril
피비게르 : fibiger
피사 : pisa
피사노 : pisano
피사레프 : pisarev
피사로 : pissarro
피셈스키 : pisemski
피셔 : fischer
피셔 : vischer
피스 : piece
피스카토르 : piscator
피스크 : fiske
피스톤 : piston
피시 : fish
피시바닐 : picibanil
피시플레이트 : fishplate
피아노 : piano
피아노스코어 : pianoscore
피아제 : piaget
피아체타 : piazzetta
피아치 : piazzi
피아프 : piaf
피어 : pierre
피어리 : peary
피어슨 : pearson
피에로 : pierrot
피에르네 : piern
피우라 : piura
피우스 : pius
피전 : pigeon
피조 : fizeau
피조스티그민 : physostigmine
피진 : pidgin
피처 : feature
피처 : pitcher
피츠너 : pfitzner
피츠버그 : pittsburgh
피츠제럴드 : fitzgerald
피치노 : ficino
피치블렌드 : pitchblende
피치아웃 : pitchout
피친니 : piccinni
피칭 : pitching
피카르 : picard
피카소 : picasso
피커 : picker
피커딜리 : piccadilly
피커링 : pickering
피컬 : picul
피케팅 : picketing
피켓 : picket
피코 : pico
피코세컨드 : picosecond
피코시안 : phycocyan
피코에리트린 : phycoerythrin
피코패럿 : picofarad
피콜로 : piccolo
피크 : peak
피크노미터 : pycnometer
피클 : pickle
피타고라스 : pythagoras
피터 : peter
피테칸트로푸스 : pithecanthropus
피토트론 : phytotron
피튜이트린 : pituitrin
피트 : feet
피트 : peat
피트 : pitt
피트니스 : fitness
피트리 : petrie
피파 : fifa
피파 : pipa
피페라진 : piperazine
피페린 : piperine
피펫 : pipette
피포 : fifo
피프틴 : fifteen
피핀 : pippin
피히테 : fichte
픽셀 : pixel
픽션 : fiction
픽업 : pickup
픽처 : picture
픽퍼드 : pickford
핀 : pin
핀란드 : finland
핀란디아 : finlandia
핀센 : finsen
핀스 : pins
핀치콕 : pinchcock
핀투리키오 : pinturicchio
필 : peel
필 : pill
필그림 : pilgrim
필드 : field
필딩 : fielding
필라델피아 : philadelphia
필라멘트 : filament
필라스터 : pilaster
필레몬 : philemon
필로소마 : phyllosoma
필로카르핀 : pilocarpine
필록테테스 : philoctetes
필론 : philon
필롤라오스 : philolaos
필름 : film
필리듐 : pilidium
필리버스터 : fillibuster
필리프 : philippe
필리핀 : philippines
필립스 : phillips
필링 : pilling
필머 : filmer
필모그래프 : filmograph
필모폰 : filmophon
필몬 : filmon
필터 : filter
필하모니 : philharmony
필하모닉 : philharmonic
필하아모닉 : philharmonic
필히너 : filchner
핌 : pym
핑 : ping
핑크 : pink
하겐 : hagen
하겐베크 : hagenbeck
하네만 : hahnemann
하노버 : hannover
하노이 : hanoi
하다 : hadda
하데스 : hades
하드 : hard
하드론 : hadron
하드리아누스 : hadrianus
하드보드 : hardboard
하드톱 : hardtop
하드헤드 : hardhead
하든 : harden
하디 : hardy
하딩 : harding
하라레 : harare
하렘 : harem
하르게이사 : hargeisa
하르나크 : harnack
하르마탄 : harmattan
하르툼 : khartoum
하르트만 : hartmann
하리 : hari
하마 : hamah
하마단 : hamadan
하멜 : hamel
하멜른 : hameln
하모늄 : harmonium
하모니카 : harmonica
하모닉스 : harmonics
하바네라 : habanera
하버 : haber
하버드 : harvard
하비 : harvey
하셀 : hassel
하스 : haas
하스 : haworth
하슬러 : hassler
하시디즘 : hasidism
하와이 : hawaii
하우 : howe
하우라 : howrah
하우스 : house
하우스먼 : housman
하우스호퍼 : haushofer
하우얼스 : howells
하울링 : howling
하웁트만 : hauptmann
하이 : high
하이네 : heine
하이데거 : heidegger
하이델베르크 : heidelberg
하이드 : hyde
하이드로그래프 : hydrograph
하이드로포일 : hydrofoil
하이드로폰 : hydrophone
하이드롤라이트 : hydrolite
하이든 : haydn
하이디 : heidi
하이라이트 : highlight
하이만스 : heymans
하이모 : hymo
하이볼 : highball
하이브리드 : hybrid
하이엇 : hyatt
하이에나 : hyena
하이예르만스 : heijermans
하이웨이 : highway
하이제 : heyse
하이킹 : hiking
하이테크 : hightech
하이파 : haifa
하이퍼미디어 : hypermedia
하이퍼소닉 : hypersonic
하이퍼인플레이션 : hyperinflation
하이퍼텍스트 : hipertext
하이페츠 : heifetz
하이포 : hypo
하이포플랑크톤 : hypoplankton
하이퐁 : haipong
하이픈 : hyphen
하일레 : haile
하임 : heym
하차투리안 : khachaturyan
하키 : hockey
하테비스트 : hartebeest
하트 : hart
하트 : harte
하트 : heart
하트랜드 : heartland
하트퍼드 : hartford
하틀라인 : hartline
하프 : half
하프 : harp
하프늄 : hafnium
하프시코드 : harpsichord
하프토닝 : halftoning
한 : hahn
한센 : hansen
한슬리크 : hanslick
할라파 : jalapa
할러 : haller
할레 : halle
할렘 : harlem
할로탄 : halothane
할로페리돌 : haloperidol
할론 : halon
할리우드 : hollywood
할리퀸 : harlequin
할박스 : hallwachs
함 : ham
함메르페스트 : hammerfest
함무라비 : hammurabi
함순 : hamsun
합텐 : hapten
핫 : hot
해로 : harrow
해리스 : harris
해링턴 : harrington
해머 : hammer
해머록 : hammerlock
해먼드 : hammond
해밀턴 : hamilton
해시 : hash
해싱 : hashing
해저드 : hazard
해즐릿 : hazlitt
해치백 : hatchback
해커 : hacker
해크니 : hackney
해클링 : hackling
해킹 : hacking
해트 : hat
핸드 : hand
핸드백 : handbag
핸드볼 : handball
핸드셰이킹 : handshaking
핸드스프링 : handspring
핸드카 : handcar
핸드홀드 : handhold
핸들 : handle
핸들링 : handling
핼리 : halley
핼리팩스 : halifax
햄 : ham
햄버거 : hamburger
햄스터 : hamster
햄프턴 : hampton
허니콤 : honeycomb
허더즈필드 : huddersfield
허드슨 : hudson
허들 : hurdles
허리케인 : hurricane
허밍 : humming
허브 : herb
허브 : hub
허블 : hubble
허스키 : husky
허스트 : hearst
허치슨 : hutcheson
허친슨 : hutchinson
허턴 : hutton
헉슬리 : huxley
헌터 : hunter
헌트 : hunt
헌팅턴 : huntington
헐러 : hurler
헐레이션 : halation
헐버트 : hulbert
험프리 : humphrey
헝가리 : hungary
헝가리안 : hungarian
헤나 : henna
헤니 : henie
헤다 : hedda
헤드 : head
헤드기어 : headgear
헤드라이트 : headlight
헤드록 : headlock
헤드엔드 : headend
헤드폰 : headphone
헤딩 : heading
헤라 : hera
헤라클레스 : heracles
헤라트 : herat
헤로데스 : herodes
헤로도토스 : herodotos
헤로인 : heroin
헤로필로스 : herophilos
헤론 : heron
헤르니아 : hernia
헤르더 : herder
헤르메스 : hermes
헤르바르트 : herbart
헤르손 : kherson
헤르츠 : hertz
헤르츠스프룽 : hertzsprung
헤르츨 : herzl
헤르쿨레스 : hercules
헤르트비히 : hertwig
헤리오트로핀 : heriotropine
헤링 : hering
헤마토크롬 : hematochrome
헤마토크릿 : hematocrit
헤모글로빈 : haemoglobin
헤모글로빈 : hemoglobin
헤모시아닌 : hemocyanin
헤모코니아 : hemoconia
헤모트로페 : hemotrophe
헤밍웨이 : hemingway
헤베시 : hevesy
헤벨 : hebbel
헤벨 : hebel
헤브라이즘 : hebraism
헤브론 : hebron
헤비 : heavy
헤세 : hesse
헤스 : hess
헤스티아 : hestia
헤스페리데스 : hesperides
헤스페리딘 : hesperidin
헤시오도스 : hesiodos
헤어네트 : hairnet
헤어브러시 : hairbrush
헤어스톤 : hairstone
헤어클립 : hairclip
헤어핀 : hairpin
헤이그 : hague
헤이덴스탐 : heidenstam
헤이로프스키 : heyrovsk
헤이븐 : haven
헤이스팅스 : hastings
헤일 : hale
헤일로테스 : heilotes
헤일리지 : haylage
헤임달 : heimdall
헤지라 : hegira
헤지호그 : hedgehog
헤징 : hedging
헤카타이오스 : hecataeos
헤카테 : hecate
헤켈 : haeckel
헤테로 : hetero
헤테로다인 : heterodyne
헤테로시스 : heterosis
헤테로카리온 : heterokaryon
헤테로포니 : heterophony
헤테롤라이트 : hetaerolite
헤파린 : heparin
헤파이스토스 : hephaestos
헤파토톡신 : hepatotoxin
헥사데센 : hexadecen
헥사데칸 : hexadecane
헥사메틸렌디아민 : hexamethylenediamine
헥사민 : hexamine
헥사클로로벤젠 : hexachlorobenzene
헥사클로로펜 : hexachlorophene
헥산 : hexane
헥산알 : hexanal
헥소겐 : hexogen
헥소오스 : hexose
헥시톨 : hexitol
헥토그램 : hectogram
헥토리터 : hectoliter
헥토미터 : hectometer
헥트 : hecht
헨더슨 : henderson
헨레 : henle
헨젠 : hensen
헨치 : hench
헬 : hell
헬라스 : hellas
헬레나 : helena
헬레네 : helene
헬레니즘 : hellenism
헬롯 : helot
헬륨 : helium
헬리골랜드 : heligoland
헬리시티 : helicity
헬리오그래프 : heliograph
헬리오미터 : heliometer
헬리오스 : helios
헬리오스코프 : helioscope
헬리오타이프 : heliotype
헬리오트로프 : heliotrope
헬리컬 : helical
헬리코프리온 : helicoprion
헬리콘 : helicon
헬리콥터 : helicopter
헬리포트 : heliport
헬먼 : hellman
헬멧 : helmet
헬싱키 : helsinki
헬싱포르스 : helsingfors
헬퍼 : helper
헴록 : hemlock
헴스티치 : hemstitch
헵번 : hepburn
헵탄 : heptane
헵토오스 : heptose
호가스 : hogarth
호노리우스 : honorius
호놀룰루 : honolulu
호니아라 : honiara
호닝 : horning
호도그래프 : hodograph
호도스코프 : hodoscope
호라산 : khorasan
호라이 : horae
호라이즌 : horizon
호라티우스 : horatius
호로비츠 : horowitz
호루스 : horus
호르무즈 : hormuz
호르친 : khorchin
호르크하이머 : horkheimer
호르티 : horty
호른 : horn
호마트로핀 : homatropine
호메로스 : homeros
호메오스타시스 : homeostasis
호메이니 : khomeini
호모시스테인 : homocysteine
호모지나이저 : homogenizer
호모포니 : homophony
호밍 : homing
호바 : hobah
호바트 : hobart
호베마 : hobbema
호브 : hob
호브드 : hovd
호산나 : hosanna
호세아 : hosea
호손 : hawthorne
호스피스 : hospice
호스피털리즘 : hospitalism
호이겐스 : huygens
호이스 : heuss
호이스트 : hoist
호자 : hoxha
호젠트 : zhozhent
호조 : khojo
호치키스 : hotchkiss
호컴 : hokum
호크스 : hawks
호텔 : hotel
호토 : khoto
호퍼 : hofer
호프 : hope
호프마이스터 : hofmeister
호프만 : hoffman
호프만 : hofmann
호프만슈발다우 : hofmannswaldau
호프만슈탈 : hofmannsthal
혼 : horn
혼파이프 : hornpipe
혼펠스 : hornfels
홀 : hole
홀더 : holder
홀데인 : haldane
홀딩 : holding
홀란드 : holland
홀로그래피 : holography
홀론 : holon
홀뮴 : holmium
홀바인 : holbein
홀스타인 : holstein
홀스트 : holst
홀츠 : holz
홈랜드 : homeland
홈룸 : homeroom
홈스 : homs
홈스트레치 : homestretch
홈스펀 : homespun
홉스 : hobbes
홉슨 : hobson
홉킨스 : hopkins
화이트 : white
화이트헤드 : whitehead
화이트호스 : whitehorse
후드 : hood
후버 : hoover
후설 : husserl
후안 : juan
후지스탄 : khuzistan
후크발라합 : hukbalahap
후텐 : hutten
후프 : hoop
후흐 : huch
훅 : hooke
훌라 : hula
훌라구 : hulagu
훔볼트 : humboldt
훔퍼딩크 : humperdinck
훨러 : whirler
휘슬 : whistle
휘슬러 : whistler
휘트니 : whitney
휘트스톤 : wheatstone
휘트워스 : whitworth
휘티어 : whittier
휘핏 : whippet
휠 : wheel
휠체어 : wheelchair
휴머니스트 : humanist
휴머니즘 : humanism
휴스 : hughes
휴스턴 : houston
휴스턴 : huston
흄 : hume
흐루시초프 : khrushchov
흘레브니코프 : khlebnikov
히기에이아 : hygieia
히노키티올 : hinokitiol
히드라 : hydra
히드라지드 : hydrazide
히드라진 : hydrazine
히드랄라진 : hydralazine
히드로겔 : hydrogel
히드로늄 : hydronium
히드로졸 : hydrosol
히드로코르티손 : hydrocortisone
히드로퀴논 : hydroquinone
히드로폴립 : hydropolyp
히드록시진 : hydroxyzine
히드록시케톤 : hydroxyketone
히드록실아민 : hydroxylamine
히드롤라아제 : hydrolase
히드리아 : hydria
히라코테륨 : hyracotherium
히라쿠드 : hirakud
히로인 : heroine
히루딘 : hirudin
히르티우스 : hirtius
히말라얀 : himalayan
히브 : heib
히비스커스 : hibiscus
히스 : heath
히스 : his
히스타민 : histamine
히스테리시스 : hysteresis
히스토그램 : histogram
히스톤 : histone
히스티딘 : histidine
히아신스 : hyacinth
히아킨토스 : hyakinthos
히알린 : hyaline
히에로글리프 : hieroglyph
히에로니무스 : hieronymus
히옐마이트 : hjelmite
히오시아민 : hyoscyamine
히치콕 : hitchcock
히치하이크 : hitchhike
히커리 : hickory
히타이트 : hittite
히터 : heater
히터 : hitter
히토르프 : hittorf
히트 : heat
히트 : hit
히틀러 : hitler
히팅 : heating
히팅 : hitting
히파르코스 : hipparchos
히파티아 : hypatia
히페르보레이 : hyperborei
히페르텐시나아제 : hypertensinase
히페리온 : hyperion
히포콘드리아시스 : hypochondriasis
히포크라테스 : hippocrates
히폴리투스 : hippolytus
히프 : hip
히프노스 : hypnos
히프노시스 : hypnosis
히피 : hippie
힉소스 : hyksos
힉스 : hicks
힌데미트 : hindemith
힌덴부르크 : hindenburg
힌두 : hindu
힌셜우드 : hinshelwood
힌지 : hinge
힐 : heel
힐 : hill
힐데브란트 : hildebrand
힐로 : hilo
힐베르트 : hilbert
힐빌리 : hillbilly
힐턴 : hilton
힐티 : hilty
힐퍼딩 : hilferding
힘러 : himmler
힙본 : hipbone
힙합 : hiphop